# Rime table
# coding: utf-8
#@/db_name	custom_phrase_double.txt
#@/db_type	tabledb
#
# 自定义短语
# 可为方案增加一些要置顶的词汇及短语，例如邮箱、手机号、常用短语等等。编码可以随便起，不限于拼音。
#
# 此文件，列出数千常用单字的自然码单辅编码，用于减少翻页，加快单字输入。
#
# 适用于双拼。全拼默认为 custom_phrase.txt ，且上面的 db_name 为 custom_phrase.txt
#
# 以 Tab 分割：词汇<Tab>编码<Tab>权重
#
# 这个文件内的字词会占据最高权重（即排在候选项的最前面，因为指定了高权重 custom_phrase/initial_quality: 99）。
# 但不与其他翻译器互相造词，如果使用了完整编码，那么这个字或词将无法参与造词，即自造词无法被记住。
# 所以只建议固定非完整拼音的编码，如果需求是置顶指定拼音的候选项，请参考方案中的 pin_cand_filter。
#
# 最下面的英文是因为一些常用单词的第一候选项被纠错覆盖了，如 Amazon 被纠错为「a ma zong 阿妈粽」，期望的 Amazon 跑到第二个候选项了，所以这里给它固定死喽。
#
# version: "2024-03-12"
#
# 此行之后不能写注释

#噷	hm
#呣	m
#呒	m

η	aita
爫	aizitou
α	alpha
＆	and
＠	at
Ⅷ	ba
⑧	ba
％	baifenhao
©	banquan
⌒	banyuan
宀	baogaitou
勹	baozitou
≠	bdy
≯	bdy
β	beta
％	bfh
ª	biaozhia
∪	bingji
疒	bingzitou
髟	binzitou
～	blh
～	bolanghao
≯	budayu
≠	budengyu
≮	buxiaoyu
≮	bxy
廾	caotoudi
艹	caozitou
×	ch
÷	ch
×	cha
∝	chengbili
×	chenghao
÷	chuhao
⊥	chuizhi
×	cuo
√	dagou
｛	dakuohao
｝	dakuohao
卩	danerpang
亻	danrenpang
‘	danyinhao
’	danyinhao
礻	danyipang
▽	daosanjiao
▼	daosanjiao
＞	dayu
≥	dayudengyu
＞	dayuhao
◐	dbd
∶	dbh
の	de
Δ	deerta
δ	delta
Δ	delta
＝	dengyu
＝	dengyuhao
√	dg
，	dh
、	dh
☎	dianhua
☏	dianhua
℡	dianhua
｛	dkh
｝	dkh
，	douhao
°	du
√	dui
◐	duibidu
∶	duibihao
、	dunhao
#[㎎㎏㎜㎝㎞㎡㏄㏎㏑㏒㏕]	dwfh
#[АБВГДЕЖЗИЙКЛМНОПРСТУФХЦЧШЩЪЫЬЭЮЯЁ]	dxew
#[ⅠⅡⅢⅣⅤⅥⅦⅧⅨⅩⅪⅫ]	dxlm
#[ァアィイゥウェエォオカガキギクグケゲコゴサザシジスズセゼソゾタダチヂッツヅテデトドナニヌネノハバパヒビピフブプヘベペホボポマミムメモャヤュユョヨラリルレロヮワヰヱヲンヴヵヶーヽヾ]	dxrw
#[ΑΒΓΔΕΖΗΘΙΚΛΜΝΞΟΠΡΣΤΥΦΧΨΩ]	dxxl
＝	dy
＞	dy
≥	dydy
‘	dyh
’	dyh
の	e
ε	epsilon
Ⅱ	er
②	er
η	eta
♢	fangkuai
♦	fangkuai
[	fangkuohao
]	fangkuohao
☢	fangshexing
犭	fanquanpang
攵	fanwenpang
′	fen
'	fengefu
；	fenhao
§	fenjiehao
'	fgf
；	fh
§	fjh
□	fk
■	fk
♢	fk
♦	fk
[	fkh
]	fkh
－	fuhao
#[←↑→↓↖↗↘↙]	fxjt
γ	gama
γ	gamma
Γ	gamma
！	gantanhao
☭	gongchandang
❂	guomindang
囗	guozikuang
(#￣▽￣#)	haixiu
㎜	haomi
#[＄￠￡￥¤]	hbfh
※	hch
＆	he
♤	heitao
♠	heitao
♡	hongtao
♥	hongtao
♥	hongxin
♤	ht
♠	ht
♡	ht
♥	ht
✿	hua
❀	hua
ღ	hudie
ஐ	hudie
虍	huzitou
ι	iota
。	jh
＋	jh
－	jh
＋	jiahao
±	jiajian
➹	jian
✄	jiandao
♭	jiangdiao
丬	jiangzipang
－	jianhao
→	jiantou
←	jiantou
廴	jianzhipang
∠	jiao
∠	jiaodu
∩	jiaoji
纟	jiaosipang
∫	jifen
＃	jing
＃	jinghao
钅	jinzipang
Ⅸ	jiu
⑨	jiu
→	jt
☠	judu
。	juhao
❃	juhua
❁	juhua
κ	kapa
ξ	kesai
Ξ	kesai
#[⑴⑵⑶⑷⑸⑹⑺⑻⑼⑽⑾⑿⒀⒁⒂⒃⒄⒅⒆⒇]	khsz
〖	kongxinkuohao
〗	kongxinkuohao
::>_<::	ku
（	kuohao
）	kuohao
〖	kxkh
〗	kxkh
λ	lamda
Λ	lamda
λ	landa
厶	leizitou
m³	lfm
冫	liangdianshui
☼	liangdu
³	lifang
m³	lifangmi
㎝	limi
〇	ling
◇	lingxing
◆	lingxing
Ⅵ	liu
⑥	liu
亠	liuzitou
✪	longzhu
◇	lx
◆	lx
：	maohao
♣	meihua
♧	meihua
＄	meiyuan
：	mh
♣	mh
♧	mh
♨	mian
″	miao
微软	microsoft
μ	miu
MP3	mp
MP4	mp
MP5	mp
MTV	mtv
＄	my
♂	nanxing
#$(YYYY)年$(MM)月$(DD)日 $(hh):$(mm):$(ss)	now
♀	nvxing
(⊙o⊙)哦	o
Ω	omega
ω	omega
Orz	orz
Ω	oumiga
€	ouyuan
€	oy
\(^o^)/	oye
π	pai
㎡	pfm
φ	phi
Φ	phi
²	pingfang
㎡	pingfangmi
㎡	pingmi
——	pozhehao
ψ	puxi
Ψ	puxi
āáǎà	pyfha
ēéěèê	pyfhe
īíǐì	pyfhi
ōóǒò	pyfho
ūúǔù	pyfhu
ǖǘǚǜü	pyfhv
——	pzh
≡	qdy
‰	qfh
Ⅶ	qi
⑦	qi
✎	qianbi
‰	qianfenhao
㎞	qianmi
攴	qiaozipang
≡	quandengyu
☉	quandian
￥	renminbi
ρ	rho
￥	rmb
#$(YYYY)年$(MM)月$(DD)日	rq
#$(Year)-$(month)-$(day)	rq
#$(YearCn)年$(monthCn)月$(dayCn)日	rq
Ⅲ	san
③	san
∵	sandian
∴	sandian
氵	sandianshui
巛	sanguaipang
▷	sanjiao
◁	sanjiao
△	sanjiaoxing
▲	sanjiaoxing
彡	sanpiepang
↑	shang
®	shangbiao
↑	shangjiantou
凵	shangkuang
↕	shangxia
♯	shengdiao
☣	shenghua
……	shengluehao
…	shengluehao
℃	sheshidu
Ⅹ	shi
⑩	shi
【	shixinkuohao
】	shixinkuohao
✟	shizijia
饣	shizipang
阝	shuangerpang
彳	shuangrenpang
‖	shuangshuxian
“	shuangyinhao
”	shuangyinhao
衤	shuangyipang
《	shuminghao
》	shuminghao
忄	shuxinpang
Ⅳ	si
④	si
灬	sidianshui
Σ	sigma
σ	sigma
#$(YYYY)年$(MM)月$(DD)日 $(hh):$(mm):$(ss)	sj
#$(Year)-$(month)-$(day) $(Hour):$(minute):$(second)	sj
↑	sjt
△	sjx
▲	sjx
……	slh
…	slh
《	smh
》	smh
℃	ssd
『	ssmh
』	ssmh
‖	ssx
∴	suoyi
#[＋－＜＝＞±×÷∈∏∑∕√∝∞∟∠∣∥∧∨∩∪∫∮∴∵∶∷∽≈≌≒≠≡≤≥≦≧≮≯⊕⊙⊥⊿]	sxfh
【	sxkh
】	sxkh
“	syh
”	syh
#[⒈⒉⒊⒋⒌⒍⒎⒏⒐⒑⒒⒓⒔⒕⒖⒗⒘⒙⒚⒛]	szd
☼	taiyang
☀	taiyang
！	tanhao
❦	taozi
τ	tau
！	th
θ	theta
Θ	theta
牜	tiniupang
扌	tishoupang
T恤	tixu
™	tm
冖 	tubaogai
T恤	txu
#[亻彳讠饣艹丶乛亠冖宀冫丷扌氵灬丨亅丿乚勹匚冂凵爫忄丬纟疒阝刂卩犭辶廴钅礻衤罒覀夂癶耂牜虍歺糹釒飠]	vpianpang
#[亻彳讠饣艹丶乛亠冖宀冫丷扌氵灬丨亅丿乚勹匚冂凵爫忄丬纟疒阝刂卩犭辶廴钅礻衤罒覀夂癶耂牜虍歺糹釒飠]	vpp
#[❶❷❸❹❺❻❼❽❾❿⓪]	vshuzi
#[❶❷❸❹❺❻❼❽❾❿⓪]	vsz
#[ⓐⓑⓒⓓⓔⓕⓖⓗⓘⓙⓚⓛⓜⓝⓞⓟⓠⓡⓢⓣⓤⓥⓦⓧⓨⓩ]	vzimu
#[ⓐⓑⓒⓓⓔⓕⓖⓗⓘⓙⓚⓛⓜⓝⓞⓟⓠⓡⓢⓣⓤⓥⓦⓧⓨⓩ]	vzm
℃	wd
？	wenhao
♨	wenquan
？	wh
★	wjx
☆	wjx
Ⅴ	wu
⑤	wu
★	wujiaoxing
☆	wujiaoxing
∞	wuxian
☁	wuyun
∞	wx
♀	xb
♂	xb
↓	xia
↓	xiajiantou
冂	xiakuang
↑	xiangshang
↓	xiangxia
→	xiangyou
←	xiangzuo
☺	xiaolian
☻	xiaolian
＜	xiaoyu
≤	xiaoyudengyu
＜	xiaoyuhao
/	xiegang
\	xiegang
∑	xigema
❤	xin
♥	xin
♀	xingbie
♂	xingbie
θ	xita
Θ	xita
↓	xjt
#$(WeekCn)	xq
#$(YYYY)年$(MM)月$(DD)日 $(WeekCn)	xq
#$(YearCn)年$(monthCn)月$(dayCn)日 $(WeekCn)	xq
❉	xuehua
✲	xuehua
❈	xuehua
☃	xueren
彐	xuezidi
#[абвгдежзийклмнопрстуфхцчшщъыьэюяё]	xxew
♂	xxfh
#[ⅰⅱⅲⅳⅴⅵⅶⅷⅸⅹ]	xxlm
#[ぁあぃいぅうぇえぉおかがきぎくぐけげこごさざしじすずせぜそぞただちぢっつづてでとどなにぬねのはばひびぴふぶぷへべぺほぼぽまみむめもゃやゅゆょよらりるれろゎわゐゑをん゛゜ゝゞ]	xxrw
#[αβγδεζηθικλμνξοπρστυφχψω]	xxxl
＜	xy
≤	xydy
→	xyjt
←	xzjt
讠	yanzipang
￡	yb
·	yd
≈	ydy
Ⅰ	yi
①	yi
·	yidian
♪	yinfu
♬	yinfu
♩	yinfu
￡	yingbang
∵	yinwei
✚	yiyuan
→	yjt
（	ykh
）	ykh
→	you
☞	youbian
﹫	youjian
→	youjiantou
匚	youkuang
↗	youshang
↘	youxia
＠	youxiang
\	youxiegang
○	yq
●	yq
#[①②③④⑤⑥⑦⑧⑨⑩]	yqsz
↗	ysjt
·	yuandian
○	yuanquan
●	yuanquan
○	yuanzhou
≈	yuedengyu
☪	yueliang
☂	yusan
肀	yuzitou
\	yxg
↘	yxjt
ζ	zeta
±	zfh
㊣	zheng
±	zhengfuhao
＋	zhenghao
夂	zhewenpang
の	zhi
㈱	zhushihuishe
孑	zizipang
§	zjh
←	zjt
∑	zonghe
辶	zouzhipang
↖	zsjt
→	zuiyou
←	zuo
☜	zuobian
←	zuojiantou
↖	zuoshang
↙	zuoxia
/	zuoxiegang
↔	zuoyou
	zuzipang
#[㈠㈡㈢㈣㈤㈥㈦㈧㈨㈩]	zwsz
/	zxg
↙	zxjt
#[ㄅㄆㄇㄈㄉㄊㄋㄌㄍㄎㄏㄐㄑㄒㄓㄔㄕㄖㄗㄘㄙㄧㄨㄩㄚㄛㄜㄝㄞㄟㄠㄡㄢㄣㄤㄥㄦ]	zyfh
啊	aadz
阿	aatz
吖	aadg
锕	aazz
腌	aava
爱	aiyr
哎	aidb
唉	aido
艾	ailb
挨	aiuo
癌	aiav
矮	aiob
哀	aitd
埃	aigo
碍	aimk
欸	aike
砹	aimb
隘	aita
瑷	ainr
暧	aior
毐	aigk
嗳	aidr
蔼	ailf
锿	aizd
霭	aitf
嗌	aida
叆	aibr
嫒	aibr
皑	aiuv
按	anub
安	anwb
案	anwe
俺	anja
暗	anox
氨	anvb
胺	anvb
庵	anxa
岸	anve
鞍	antb
黯	anpx
铵	anzb
桉	aneb
唵	anda
谙	ansx
埯	anga
盦	anja
垵	angb
犴	anme
鹌	anmx
𩽾	anwb
昂	ahoz
卬	ahbz
盎	ahma
肮	ahvo
奥	aotm
熬	aoac
嗷	aodh
澳	aokm
凹	aomf
傲	aojh
敖	aoah
鳌	aoaw
袄	aotm
螯	aoac
拗	aous
坳	aogs
獒	aoam
媪	aoba
岙	aotv
翱	aouz
遨	aoau
鏊	aoaz
薁	aolm
懊	aohm
璈	aonh
鏖	aoxz
骜	aoan
隩	aotm
聱	aoaq
奡	aofp
廒	aoxh
嶅	aoav
吧	badm
把	baum
八	bahb
巴	bamb
扒	bauh
拔	baui
罢	bayk
叭	badh
爸	bahm
靶	batm
钯	bazm
疤	baam
霸	batv
芭	balm
耙	baam
坝	bago
灞	bakv
捌	baup
跋	bapi
粑	bapm
魃	baai
鲃	bawm
妭	babi
鲅	bawi
菝	bali
羓	bagm
胈	bavi
朳	baeh
笆	barm
岜	bavm
蚆	bacm
白	blub
摆	bluk
拜	blua
百	blfu
掰	bluu
败	bloh
柏	bleu
佰	blju
稗	blxn
捭	blun
伯	blju
版	bjar
班	bjnn
半	bjhu
板	bjer
般	bjir
办	bjsh
搬	bjur
拌	bjuu
斑	bjnn
伴	bjju
瓣	bjnn
扮	bjup
扳	bjur
绊	bjiu
颁	bjhw
坂	bjgr
阪	bjtr
钣	bjzr
癍	bjan
柈	bjeu
攽	bjhh
瘢	bjar
昄	bjor
湴	bjkc
靽	bjtu
𨭉	bjvz
帮	bhar
棒	bheu
榜	bhel
磅	bhml
邦	bhat
绑	bhit
镑	bhzl
傍	bhjl
蚌	bhca
浜	bhkh
谤	bhsl
梆	bhet
膀	bhvl
搒	bhul
玤	bhna
蒡	bhll
塝	bhgl
𠳐	bhdt
包	bknv
宝	bkwi
报	bkur
保	bkje
爆	bkck
抱	bkuv
薄	bklk
堡	bkjg
曝	bkok
饱	bkqv
鲍	bkwv
煲	bkjc
剥	bkbp
暴	bkok
豹	bkmi
刨	bknp
褒	bkte
胞	bkvv
葆	bkle
苞	bklv
鸨	bkvx
炮	bkcv
雹	bktv
孢	bkhv
枹	bkev
龅	bklv
趵	bkpi
褓	bkte
瀑	bkkk
被	bztr
背	bzav
倍	bzjd
呗	bzdo
杯	bzec
北	bzav
贝	bzob
备	bzhq
悲	bzrh
碑	bzmn
辈	bzry
钡	bzzo
焙	bzcd
邶	bzat
卑	bzun
悖	bzhh
孛	bznh
蓓	bzld
陂	bztr
碚	bzmd
琲	bznr
惫	bzhh
鹎	bzux
鞴	bztt
狈	bzmo
棓	bzed
椑	bzen
褙	bztv
糒	bzpt
臂	bzcv
鐾	bzcz
鞁	bztr
𬇙	bzko
本	bfef
笨	bfrf
奔	bfml
苯	bflf
畚	bfkq
贲	bfno
锛	bfzl
犇	bfqq
坌	bfhg
夯	bfms
倴	bfjl
栟	bfel
崩	bgvv
蹦	bgpv
泵	bgmk
甭	bgct
绷	bgiv
嘣	bgdv
迸	bghu
甏	bghr
蚌	bgca
琫	bgnu
祊	bgfl
镚	bgzv
比	bivv
笔	birv
逼	bifu
必	biht
币	bitr
鼻	biol
臂	bicv
壁	bicg
彼	biwr
毕	bivn
避	bicu
碧	binm
哔	bidn
闭	biat
弊	bifl
璧	bici
铋	bizt
敝	bifh
匕	bivb
毙	bivv
俾	bijn
鄙	bidt
蔽	bilh
婢	bibn
濞	bikl
庇	bixv
畀	biql
陛	bitg
弼	bibb
痹	bial
妣	bibv
髀	bifn
吡	bidv
屄	bice
箅	birl
滗	bikv
庳	bixn
嬖	bicb
芘	bilv
沘	bikv
毖	bivt
蓖	bilv
裨	bitn
苾	bilt
愎	bihh
篦	birv
邲	biht
皕	bifu
襞	bict
萆	biln
荜	biln
薜	biln
跸	bipn
咇	bidt
珌	bint
舭	biiv
辟	bicn
佖	bijt
赑	bioo
荸	bilh
诐	bisr
筚	birn
秕	bixv
贲	bino
狴	bimg
佛	bijt
觱	bint
馝	bixt
泌	bikt
秘	bixt
鲾	biwq
坒	bivg
便	bmjb
边	bmsu
变	bmzr
遍	bmmu
编	bmii
贬	bmor
辩	bmnn
扁	bmmi
鞭	bmtb
辨	bmnn
蝙	bmci
卞	bmzy
煸	bmci
弁	bmkl
辫	bmnn
匾	bmni
汴	bmky
抃	bmuy
昪	bmol
苄	bmly
笾	bmru
砭	bmmr
鳊	bmwi
萹	bmli
忭	bmhy
碥	bmmi
褊	bmti
𨚕	bmkt
𰻝	bdeu
表	bcat
标	bcef
婊	bcbt
飙	bcmb
镖	bczf
彪	bcze
裱	bctt
膘	bcvf
杓	bcei
鳔	bcwf
镳	bczc
骉	bcnn
熛	bccf
摽	bcuf
幖	bcrf
骠	bcnf
藨	bclc
儦	bcjc
瀌	bckc
俵	bcjt
飑	bcov
瘭	bcaf
脿	bcvt
别	bxdp
憋	bxfh
鳖	bxfw
瘪	bxaj
蹩	bxfp
癿	bxua
宾	bnwh
斌	bnvs
彬	bnee
髌	bnfh
鬓	bnph
滨	bnkh
豳	bnvj
邠	bnht
缤	bnih
膑	bnvh
殡	bngh
濒	bnkw
摈	bnuh
玢	bnnp
傧	bnjh
镔	bnzh
槟	bneh
并	byhl
病	byaj
兵	byth
冰	bywk
饼	byql
柄	byej
丙	byfj
禀	byzf
屏	bycl
秉	byxb
炳	bycj
蛃	bycj
昺	byoj
摒	byul
槟	byeh
邴	byft
栟	byel
波	bokr
博	bonk
播	bouq
薄	bolk
拨	boui
伯	boju
铂	bozu
搏	bouk
啵	bodr
钵	bozf
勃	bons
驳	bonb
玻	bonr
脖	bovh
帛	bour
剥	bobp
跛	bopr
亳	bogr
箔	boru
柏	boeu
孛	bonh
泊	boku
钹	bozi
渤	boks
镈	bozk
僰	boej
菠	bolr
擘	bocu
浡	bokh
舶	boiu
嶓	bovq
膊	bovk
哱	bodh
砵	bomf
卜	boyb
踣	bopd
簸	borr
鹁	bonx
檗	boce
鲌	bowu
蕃	bolq
艴	botm
趵	bopi
馞	boxh
袯	boti
饽	boqh
礴	bomk
欂	boek
𬭛	bozr
不	bucb
部	buit
补	buty
步	buss
布	bunr
簿	burk
钚	buzc
捕	buun
卜	buyb
怖	buhr
卟	budy
晡	buon
埠	bugn
逋	bunu
堡	bujg
哺	budn
蔀	bult
瓿	buir
醭	buyi
埔	bugn
埗	bugs
𬷕	bunx
擦	cauf
嚓	cadf
才	clnt
菜	clle
踩	clpe
猜	clmv
蔡	cllf
财	clot
采	clye
材	clet
裁	clnt
彩	clye
睬	clqe
偲	cljh
惨	cjhe
餐	cjgq
残	cjgp
参	cjke
蚕	cjfc
粲	cjgp
灿	cjcv
骖	cjne
惭	cjht
璨	cjnp
黪	cjpe
䅟	cjxe
藏	chlq
仓	chjz
舱	chiz
苍	chlz
沧	chkz
鸧	chjx
伧	chjz
草	ckln
槽	ckeo
曹	ckfo
操	ckue
艹	cklc
糙	ckpu
屮	cksc
嘈	ckdo
漕	ckko
芔	cksl
肏	ckjj
艚	ckio
螬	ckco
𥕢	ckmo
侧	cejp
测	cekp
册	ceic
策	cerm
厕	cexp
恻	cehp
𤭢	czzr
岑	cfva
涔	cfka
参	cfke
曾	cgho
层	cgcb
蹭	cgpo
噌	cgdo
嶒	cgvo
差	iagu
茶	iale
查	iaef
插	iaup
叉	iari
侘	iajr
茬	ialg
镲	iazf
察	iawf
猹	iamf
搽	iaue
槎	iaeu
岔	iahv
檫	iaef
杈	iaei
嚓	iadf
碴	iamf
姹	iabr
汊	iaki
衩	iati
锸	iazp
垞	iagr
诧	iasr
馇	iaqf
刹	iabp
喳	iadf
蹅	iapf
嵖	iavf
𥻗	iapf
拆	ilui
柴	ilse
差	ilgu
钗	ilzi
豺	ilmt
虿	ilfc
侪	iljq
瘥	ilau
茝	illq
产	ijix
铲	ijzx
馋	ijqw
缠	ijid
禅	ijfn
蝉	ijcn
掺	ijue
颤	ijzw
搀	ijuw
谗	ijsw
浐	ijkx
婵	ijbn
蟾	ijcs
澶	ijkf
觇	ijye
阐	ijan
躔	ijpg
襜	ijts
谄	ijsp
镡	ijzn
刬	ijfp
辿	ijvu
忏	ijhl
巉	ijvw
韂	ijts
羼	ijcg
廛	ijxg
潺	ijkh
梴	ijeu
孱	ijch
蒇	ijlo
啴	ijdn
单	ijhn
骣	ijnh
镵	ijzw
瀍	ijkg
旵	ijov
冁	ijht
儳	ijjw
𬊤	ijcn
唱	ihdo
场	ihge
长	ihpc
常	ihsr
厂	ihxc
尝	ihsb
肠	ihve
畅	ihoe
昌	ihoo
偿	ihjb
敞	ihsh
娼	ihbo
鬯	ihpv
怅	ihhp
倡	ihjo
昶	ihio
猖	ihmo
嫦	ihbr
氅	ihsv
伥	ihjp
苌	ihlp
鲳	ihwo
菖	ihlo
徜	ihws
裳	ihst
阊	ihao
鲿	ihwb
惝	ihhs
𬬮	ihzp
超	ikpd
抄	ikut
炒	ikct
朝	iknv
潮	ikkv
吵	ikdt
钞	ikzt
巢	ikoe
嘲	ikdv
焯	ikcn
晁	ikow
怊	ikhd
绰	ikin
弨	ikbd
耖	ikat
车	ieyc
扯	ieus
撤	ieuh
彻	iewp
掣	iequ
澈	iekh
坼	iegi
尺	ieci
砗	iemy
㬚	ieoh
陈	ifty
趁	ifpe
臣	ifqc
沉	ifko
辰	iffc
尘	ifyg
琛	ifne
抻	ifug
嗔	ifdh
衬	iftk
晨	ifof
称	ifxy
宸	ifwf
谶	ifsf
谌	ifsa
瞋	ifqh
忱	ifhp
梣	ifea
煁	ifca
榇	ifee
龀	iflv
疢	ifac
棽	ifea
碜	ifme
郴	ifet
𬘭	ifie
成	igna
称	igxy
城	igga
呈	igdn
乘	igxv
撑	iguu
橙	igez
程	igxn
秤	igxh
盛	igna
承	igat
诚	igsa
丞	igaf
澄	igkz
逞	igdu
惩	igwh
枨	igep
埕	iggn
骋	igna
铖	igza
澂	igkh
珵	ignn
琤	ignb
塍	igvg
偁	igjg
蛏	igcg
赪	iggo
噌	igdo
酲	igyn
宬	igwa
柽	igeg
瞠	igqg
珹	igna
牚	igsl
晟	igoa
铛	igzb
憕	ighz
裎	igtn
庱	igxh
吃	iida
池	iike
持	iiuk
赤	iigc
尺	iici
迟	iicu
齿	iilc
敕	iixh
痴	iiad
驰	iine
翅	iicz
耻	iiqs
嗤	iidc
豉	iizc
斥	iiti
螭	iicv
叱	iidv
彳	iiwc
蚩	iisc
炽	iich
笞	iird
哧	iidc
媸	iibc
饬	iiqs
侈	iijl
弛	iibe
褫	iitz
魑	iiav
摛	iiuv
鸱	iibx
啻	iiid
瘛	iiah
漦	iiak
墀	iigq
茌	iilg
匙	iiov
眵	iiql
篪	iirz
傺	iijf
踟	iipd
胣	iive
瓻	iibr
痓	iiay
𫄨	iiir
冲	iswg
重	isld
充	isbp
虫	iscc
宠	iswt
崇	isvf
铳	iszp
舂	isap
憧	ishd
摏	isup
艟	isid
翀	iszg
忡	ishg
茺	islp
涌	iskt
种	isxg
珫	isnp
漴	iskf
㳘	iskp
抽	ibud
丑	ibag
臭	ibom
愁	ibxh
瞅	ibqc
仇	ibjk
筹	ibrk
稠	ibxd
酬	ibyo
雠	ibuu
俦	ibjk
绸	ibid
畴	ibqk
瘳	ibae
惆	ibhd
杻	ibeg
帱	ibrk
椆	ibed
犨	ibuq
踌	ibpk
侴	ibjp
出	iusm
处	iuhy
除	iutx
初	iutp
楚	iuet
厨	iuxk
触	iuxc
褚	iuto
杵	iuen
储	iujo
锄	iuzs
怵	iuhi
雏	iuxu
橱	iuek
畜	iuzq
黜	iupm
刍	iuxb
础	iumm
俶	iujr
楮	iueo
矗	iunf
亍	iuwc
滁	iukx
绌	iuim
樗	iuea
憷	iuht
斶	iutc
搐	iuuq
摴	iuua
躇	iupo
蜍	iucx
濋	iukt
蹰	iupk
䝙	iumb
䢺	iust
琡	iunr
𬺓	iult
欻	iwce
踹	iypl
揣	iyul
搋	iyuz
啜	iydr
穿	irel
传	irji
船	irid
川	iroc
串	irdg
氚	irvo
喘	irdl
钏	irzo
舛	irlv
椽	irej
遄	irvu
床	idxe
创	idjp
窗	ideh
闯	idan
疮	idaz
怆	idhz
幢	idrd
噇	iddd
吹	ivde
锤	ivzg
捶	ivug
垂	ivlg
炊	ivce
槌	iveu
圌	ivrl
棰	iveg
倕	ivjg
陲	ivtg
纯	ipis
蠢	ipac
春	ipao
唇	ipfd
醇	ipyh
椿	ipeo
淳	ipkh
蝽	ipco
鹑	ipgx
莼	ipls
瑃	ipno
䲠	ipwo
堾	ipgo
𬭚	ipzh
戳	iozp
啜	iodr
辍	ioyr
绰	ioin
龊	iolp
踔	iopn
逴	ioyu
惙	iohr
次	ciwe
此	cisv
词	cisd
刺	ciep
赐	cioe
磁	cimi
茨	cile
呲	cidv
辞	cian
雌	cisu
瓷	ciwr
祠	cifd
慈	cihh
泚	cikv
疵	ciav
伺	cijd
玼	cinv
糍	cipi
跐	cipv
差	cigu
茈	cilv
兹	cihi
佽	cije
鹚	cihx
莿	cilp
𫚖	cisw
从	csjj
葱	cslh
聪	csqh
丛	csjf
琮	csnf
悰	cshf
骢	csnh
枞	csej
璁	csnh
淙	cskf
熜	csch
匆	csni
囱	csth
苁	cslj
凑	cbwm
腠	cbvm
辏	cbym
粗	cupf
醋	cuyo
促	cujp
簇	curo
蹙	cunp
蹴	cupo
猝	cumn
殂	cugf
徂	cuwf
卒	cuzn
蔟	culo
窜	creg
蹿	crpg
汆	crjk
篡	crrk
爨	crpc
攒	cruo
撺	crug
镩	crzg
催	cvju
崔	cvvu
脆	cvvz
翠	cvzn
啐	cvdn
萃	cvln
摧	cvuu
淬	cvkn
粹	cvpn
毳	cvvv
璀	cvnu
悴	cvhn
瘁	cvan
漼	cvku
缞	cvif
榱	cvef
寸	cpkc
存	cpnh
村	cpek
邨	cpft
皴	cpkr
忖	cphk
错	cozo
搓	couu
挫	coug
措	couo
锉	cozg
厝	coxo
撮	cour
蹉	copu
矬	coog
痤	coag
瑳	conu
嵯	covu
鹾	coyu
磋	comu
脞	covg
棤	coeo
莝	colg
大	damd
打	daua
答	dard
达	damu
搭	daud
哒	dadu
嗒	dadd
妲	dabf
鞑	datu
怛	dahf
沓	dako
炟	dacf
跶	dapu
笪	darf
耷	damq
靼	datf
垯	dagu
溚	dakd
瘩	daad
褡	datd
荙	dalu
鿎	damu
𨱏	dazd
𫟼	dazu
带	dllr
代	dljp
待	dlwk
呆	dlde
戴	dlnh
贷	dljo
袋	dljt
黛	dljp
逮	dlbu
岱	dljv
殆	dlgd
迨	dlku
呔	dldi
歹	dlgd
玳	dlnp
傣	dljk
怠	dlkh
绐	dlid
埭	dlgk
大	dlmd
轪	dlym
骀	dlnd
叇	dlbu
垈	dljg
但	djjf
单	djhn
蛋	djtc
弹	djbn
淡	djkc
丹	djmz
氮	djvc
胆	djvf
担	djuf
旦	djof
啖	djdc
掸	djun
澹	djks
亶	djzf
石	djms
诞	djsu
惮	djhn
耽	djqp
儋	djjs
聃	djqg
殚	djgn
疍	djtf
箪	djrn
憺	djhs
膻	djvf
瘅	djan
眈	djqp
萏	djlp
赕	djoc
郸	djht
疸	djaf
𫢸	djjn
𬘘	djip
当	dhyb
党	dhsp
档	dheb
挡	dhub
裆	dhtb
荡	dhle
铛	dhzb
宕	dhwm
砀	dhme
凼	dhkm
珰	dhnb
谠	dhsp
菪	dhlm
垱	dhgb
筜	dhrb
𣗋	dhep
𬍡	dhki
到	dkyp
道	dkhu
刀	dkpd
倒	dkjp
岛	dkxv
导	dkvk
盗	dkwa
叨	dkdp
氘	dkvp
稻	dkxp
捣	dkuv
悼	dkhn
纛	dkai
蹈	dkpp
祷	dkfk
捯	dkup
忉	dkhp
帱	dkrk
舠	dkip
鱽	dkwp
的	deui
得	dewk
地	dege
德	dewh
锝	dezk
嘚	dedk
得	dzwk
嘚	dzdk
扽	dfus
等	dgrk
灯	dgca
登	dghz
邓	dgrt
蹬	dgpz
凳	dgho
瞪	dgqz
噔	dgdz
镫	dgzz
戥	dgop
磴	dgmz
嶝	dgvz
澄	dgkz
璒	dgnz
地	dige
第	dirt
低	diji
滴	dikc
底	dixi
帝	diir
迪	didu
敌	diah
蒂	dilr
抵	diui
笛	dird
递	dihu
狄	dimc
弟	diht
镝	dizc
氐	dibi
嫡	dibc
堤	digt
骶	difi
棣	diek
邸	dibt
的	diui
碲	dimr
嘀	didc
睇	diqt
禘	difr
谛	disr
籴	dijp
砥	dimi
鞮	ditt
涤	dike
荻	dilc
菂	dili
娣	dibt
诋	disi
觌	dine
羝	digi
柢	diei
翟	dizu
杕	diem
髢	dipe
坻	digi
茋	dili
缔	diir
踶	dipt
媂	dibr
提	diut
蹢	dipc
玓	dini
䃅	dimn
䗖	dicr
𤧛	dinr
𬱖	didw
嗲	dwdl
点	dmyc
店	dmxd
电	dmoa
垫	dmug
碘	dmmh
殿	dmcr
颠	dmnw
典	dmih
滇	dmkh
甸	dmnq
掂	dmud
簟	dmrn
癫	dmaw
巅	dmvw
奠	dmhm
靛	dmat
钿	dmzq
踮	dmpd
佃	dmjq
淀	dmkt
玷	dmnd
惦	dmhd
坫	dmgd
癜	dmar
扂	dmmd
阽	dmtd
琔	dmnt
掉	dcun
调	dcsd
吊	dcdr
屌	dccr
叼	dcdf
钓	dczi
雕	dcmu
刁	dcaf
貂	dcmd
凋	dcwd
鲷	dcwd
碉	dcmd
铫	dczw
窎	dcex
铞	dczr
汈	dckf
跌	dxph
爹	dxhl
叠	dxrf
碟	dxme
蝶	dxce
迭	dxtu
谍	dxse
牒	dxae
昳	dxoh
鲽	dxwe
喋	dxde
堞	dxge
瓞	dxyh
耋	dxqy
垤	dxgy
绖	dxiy
楪	dxee
蹀	dxpe
𫶇	dxvr
定	dywt
顶	dyaw
丁	dyad
盯	dyqa
订	dysa
钉	dyza
鼎	dyqa
叮	dyda
碇	dymt
町	dyqa
腚	dyvt
锭	dyzt
玎	dyna
啶	dydt
酊	dyya
仃	dyja
疔	dyaa
耵	dyqa
萣	dylt
丢	dqtk
铥	dqzk
懂	dshd
动	dsbs
东	dsry
洞	dskd
冻	dswy
冬	dshw
董	dsld
栋	dsey
咚	dsdw
氡	dsvw
侗	dsjd
鸫	dsrx
胴	dsvd
峒	dsvd
恫	dshd
硐	dsmd
岽	dsvy
垌	dsgd
胨	dsvy
𬟽	dscy
都	dbqt
斗	dbjd
抖	dbuj
豆	dbzd
逗	dbzu
兜	dbup
痘	dbaz
陡	dbtp
窦	dbem
读	dbsm
蔸	dblp
蚪	dbcj
钭	dbzj
篼	dbrp
读	dusm
度	duxr
都	duqt
赌	duoo
毒	duak
堵	dugo
杜	dueg
独	dumc
渡	dukr
督	duyq
肚	duvg
镀	duzr
笃	durn
嘟	dudt
蠹	dunc
睹	duqo
妒	dubm
犊	duqm
渎	dukm
椟	duem
牍	duam
阇	duao
厾	duak
芏	dulg
黩	dupm
髑	dufc
𬭊	duzg
端	dril
段	drur
短	droz
断	drpt
椴	drer
锻	drzr
缎	drir
耑	drvl
煅	drcr
塅	drgr
簖	drrt
瑖	drnr
对	dvrk
队	dvtj
怼	dvrh
堆	dvgu
兑	dvhp
碓	dvmu
祋	dvfr
㨃	dvuh
吨	dpds
蹲	dppk
盾	dpxq
炖	dpcs
顿	dpfw
惇	dphh
墩	dpgh
遁	dpxu
钝	dpzs
敦	dpgh
趸	dpfp
囤	dprs
盹	dpqs
沌	dpks
镦	dpzh
礅	dpmh
蹾	dpph
砘	dpms
多	doll
躲	doze
夺	domk
剁	doop
朵	dooe
堕	dotg
度	doxr
舵	doiv
跺	dope
铎	dozu
哆	dodl
踱	dopr
惰	dohv
垛	doge
咄	dodm
掇	dour
埵	dogg
亸	dogn
驮	donm
哚	dode
剟	dorp
裰	dotr
饳	doqm
㙍	dogr
额	eeww
恶	eefh
呃	eedz
俄	eejp
饿	eeqp
鹅	eetx
厄	eexz
讹	eesv
鳄	eewa
鄂	eedt
娥	eebp
欸	eeke
蛾	eecp
颚	eedw
腭	eeva
锇	eezp
扼	eeuz
阿	eetz
轭	eeyz
莪	eelp
遏	eeou
谔	eesa
屙	eecz
萼	eela
锷	eeza
鹗	eedx
愕	eeha
峨	eevp
涐	eekp
垩	eefg
崿	eeva
噩	eend
哦	eedp
婀	eebz
姶	eebd
苊	eelz
堨	eegf
𥔲	eema
𫫇	eedh
诶	eiso
欸	eike
嗯	endh
恩	enrh
摁	enuh
蒽	enlh
嗯	egdh
而	erle
二	erme
儿	erpe
耳	erqe
尔	erxy
贰	erpo
饵	erqq
迩	erxu
铒	erzq
珥	ernq
鸸	erlx
洱	erkq
鲕	erwl
耏	erle
陑	ertl
咡	erdq
发	fasi
法	fakk
伐	fajp
罚	fayp
阀	faap
乏	fatr
筏	farp
珐	fank
垡	fajg
砝	famk
反	fjxr
饭	fjqr
翻	fjtz
犯	fjmz
范	fjlz
泛	fjkr
凡	fjoi
番	fjtq
烦	fjcw
返	fjxu
帆	fjri
藩	fjlq
繁	fjei
梵	fjei
樊	fjem
蕃	fjlq
贩	fjor
钒	fjzi
矾	fjmi
幡	fjrq
燔	fjcq
氾	fjkz
蘩	fjli
璠	fjnq
蹯	fjpq
畈	fjqr
墦	fjgq
𫔍	fjzq
𬸪	fjtx
放	fhlh
方	fhlf
防	fhtl
房	fhml
仿	fhjl
坊	fhgl
芳	fhll
访	fhsl
钫	fhzl
昉	fhol
纺	fhil
枋	fhel
鲂	fhwl
妨	fhbl
肪	fhvl
舫	fhil
蚄	fhcl
邡	fhlt
牥	fhql
非	fzrf
费	fzto
飞	fzcf
肺	fzvr
废	fzxi
肥	fzvm
菲	fzlr
妃	fzbv
匪	fznr
绯	fzir
斐	fzrv
吠	fzdm
沸	fzkt
啡	fzdr
霏	fztr
榧	fzer
扉	fzmr
腓	fzvr
淝	fzkm
蜚	fzrc
朏	fzvm
镄	fzzo
诽	fzsr
痱	fzar
翡	fzrz
狒	fzmt
鲱	fzwr
悱	fzhr
芾	fzlr
棐	fzre
剕	fzrp
篚	fzrr
𬴂	fznr
分	ffhp
粉	ffpp
份	ffjp
坟	ffgv
芬	fflp
粪	ffph
焚	ffec
汾	ffkp
酚	ffyp
忿	ffhh
愤	ffho
奋	ffmq
偾	ffjo
纷	ffip
氛	ffvp
棻	ffle
棼	ffep
鲼	ffwo
瀵	ffkh
玢	ffnp
翂	ffzp
吩	ffdp
坋	ffgp
鼢	ffpp
豮	ffjo
𣸣	ffko
风	fgob
封	fggk
冯	fgwn
峰	fgva
疯	fgab
缝	fgiu
奉	fgau
逢	fghu
锋	fgza
丰	fgaf
凤	fgor
枫	fgeb
蜂	fgca
俸	fgju
沣	fgka
讽	fgsb
葑	fglk
沨	fgkb
烽	fgca
酆	fgvt
唪	fgdu
砜	fgmb
崶	fgvk
赗	fgoq
浲	fgka
佛	fojt
否	fbcd
缶	fbaf
负	fuxo
附	futk
服	fuvr
副	fufp
付	fujk
福	fufq
府	fuxk
复	fueh
富	fuwq
夫	fuhf
赴	fupy
父	fuhb
扶	fuuh
氟	fuvt
赋	fuos
弗	futf
符	furk
伏	fujm
傅	fujk
幅	furq
敷	funh
芙	fulh
斧	fuht
釜	fuhz
腹	fuvh
浮	fukh
辅	fuyn
妇	fubb
甫	funf
覆	fuvh
抚	fuud
拂	fuut
腐	fuxj
缚	fuik
俘	fujh
俯	fujk
腑	fuvk
辐	fuyq
孚	fuyh
孵	fubh
佛	fujt
阜	futn
凫	fuxo
肤	fuvh
蝠	fucq
祓	fufi
脯	fuvn
芣	fulc
黼	fucn
鄜	fuxt
馥	fuxh
涪	fukd
桴	fueh
黻	fuci
苻	fulk
拊	fuuk
麸	fuah
郛	fuyt
玞	funh
簠	fura
绂	fuii
宓	fuwt
跗	fupk
茯	fulm
赙	fuok
莩	fulh
趺	fuph
茀	fult
蝮	fuch
稃	fuxh
匐	funq
罘	fuyc
驸	funk
怫	fuht
呋	fudh
袱	futm
洑	fukm
榑	fuek
鲋	fuwk
菔	fulr
滏	fukz
芾	fulr
咐	fudk
幞	furi
艴	futm
绋	fuit
蚨	fuch
韨	fugi
琈	funh
垺	fugh
讣	fusy
蜉	fuch
砆	fumh
㕮	fudb
㳇	fukb
𫓧	fuzh
𫖯	fupw
尬	gaop
嘎	gadp
噶	gadf
伽	gajd
尕	gavy
钆	gaza
咖	gadd
旮	gako
尜	gayy
轧	gaya
戛	gafp
该	glsk
改	glvh
盖	glga
钙	glza
概	gled
丐	glfa
垓	glgk
陔	gltk
溉	glkd
赅	glok
荄	gllk
戤	glvp
晐	glok
𬮿	gltv
感	gjnh
干	gjeg
敢	gjah
肝	gjve
杆	gjee
赶	gjpe
甘	gjzg
柑	gjez
淦	gjkz
赣	gjxo
苷	gjlz
擀	gjue
绀	gjiz
竿	gjre
尴	gjoa
橄	gjeh
秆	gjxe
酐	gjye
鳡	gjwh
玕	gjne
矸	gjme
泔	gjkz
坩	gjgz
旰	gjoe
疳	gjaz
澉	gjkh
虷	gjce
㽏	gjkz
刚	ghmp
岗	ghvb
港	ghkv
杠	gheu
缸	ghau
钢	ghzb
纲	ghib
肛	ghvu
冈	ghmb
罡	ghys
矼	ghmu
扛	ghuu
戆	ghxh
冮	ghwu
堽	ghgs
筻	ghrb
㭎	gheb
鿍	ghgv
高	gkgg
搞	gkug
稿	gkxg
告	gkqd
膏	gkgv
糕	gkpc
镐	gkzg
诰	gksd
皋	gkun
锆	gkzd
郜	gkqt
缟	gkig
睾	gktg
藁	gkle
杲	gkoe
篙	gkrg
槔	gken
羔	gkgc
槁	gkeg
筶	gkrd
个	gejg
各	gesg
哥	gezz
歌	geze
格	gees
割	gewp
隔	getn
咯	geds
搁	geus
戈	gepg
葛	gelf
阁	geas
铬	gezs
鸽	gejx
镉	gezn
革	getg
嗝	gedn
硌	gems
膈	gevn
鬲	geng
胳	gevs
蛤	gecd
骼	gefs
盖	gega
舸	geiz
圪	gega
疙	geaa
饹	geqs
滆	gekn
袼	gets
哿	gesz
仡	geja
合	gejd
虼	geca
塥	gegn
给	gzid
跟	gfpi
根	gfei
哏	gfdi
艮	gfig
亘	gfff
茛	gfli
更	ggfb
梗	ggeb
羹	gggm
耿	ggqc
耕	ggaq
庚	ggxj
埂	gggb
哽	ggdb
赓	ggxo
暅	ggof
鲠	ggwb
浭	ggkb
颈	ggrw
绠	ggib
鹒	ggxx
𬒔	ggmv
共	gslh
供	gsjh
弓	gsbg
工	gsug
公	gshk
宫	gswd
攻	gsuh
功	gsus
拱	gsuh
龚	gsth
汞	gsuk
贡	gsuo
恭	gslh
巩	gsui
躬	gszb
肱	gsvk
觥	gsxm
蚣	gsck
珙	gsnh
䢼	gslt
硔	gsmh
狗	gbmg
够	gbgl
勾	gbnk
钩	gbzk
购	gbok
沟	gbkk
苟	gblg
构	gbek
垢	gbgd
篝	gbrg
遘	gbqu
彀	gbgr
诟	gbsd
觏	gbqe
媾	gbbg
枸	gbeg
姤	gbbd
雊	gbgu
鞲	gbtg
句	gbgj
笱	gbrg
缑	gbio
佝	gbjg
岣	gbvg
耇	gbqg
故	guch
股	guvr
古	gucg
鼓	guhc
谷	guhg
骨	gufg
顾	guxw
钴	guzc
雇	gumu
孤	guhy
固	gurc
菇	gulc
姑	gubc
蛊	guca
箍	gurr
估	gujc
咕	gudc
瞽	guhq
沽	gukc
菰	guly
诂	gusc
辜	gucn
毂	gugr
榖	gugr
觚	guxy
贾	guvo
酤	guyc
锢	guzc
崮	guvc
堌	gugc
蛄	gucc
罟	guyc
汩	guko
鹘	gufx
轱	guyc
牯	guqc
嘏	gucr
梏	gued
鲴	guwc
呱	gudy
鹄	guqx
痼	guac
鸪	gucx
羖	gugr
瀔	gukr
臌	guvc
馉	guqf
牿	guqd
蓇	gulf
𦙶	guvc
挂	gwug
刮	gwap
瓜	gwyg
卦	gwgy
寡	gwwp
呱	gwdy
剐	gwdp
胍	gwvy
褂	gwty
栝	gwea
鸹	gwax
诖	gwsg
怪	gyhg
乖	gylv
拐	gyus
夬	gynj
掴	gyui
管	grrk
关	grhm
官	grwk
观	grre
馆	grqk
冠	grwk
灌	grku
罐	grau
棺	grek
贯	grko
惯	grho
毌	grku
倌	grjk
掼	gruo
瓘	grnu
祼	grfe
鹳	grlx
琯	grnk
鳏	grwk
筦	grrp
爟	grcu
盥	grpa
涫	grkk
纶	grij
莞	grlp
鳤	grwk
蒄	grlk
光	gdmg
广	gdxg
逛	gdmu
咣	gddm
洸	gdkm
桄	gdem
犷	gdmx
胱	gdvm
垙	gdgm
珖	gdnm
𨐈	gdym
贵	gvco
归	gvpb
鬼	gvag
柜	gven
跪	gvpz
轨	gvyk
硅	gvmg
龟	gvwg
桂	gveg
圭	gvgg
规	gvhe
诡	gvsz
瑰	gvna
珪	gvng
簋	gvra
癸	gvhm
妫	gvbi
邽	gvgt
鲑	gvwg
刿	gvvp
晷	gvod
闺	gvag
桧	gveb
刽	gvjp
鳜	gvwe
鬶	gvhn
宄	gvwk
庋	gvxc
匦	gvnk
皈	gvur
炅	gvoc
姽	gvbz
筀	gvrg
滚	gpkk
棍	gpev
鲧	gpwi
辊	gpyv
衮	gptk
绲	gpiv
磙	gpmk
过	goku
国	gori
锅	gozj
郭	gogt
果	goqe
裹	gote
粿	gope
虢	goyz
椁	goeh
馘	gohf
腘	govi
掴	goui
馃	goqe
崞	govh
呙	godj
帼	gori
蝈	goci
聒	goqa
蜾	goce
涡	gokj
埚	gogj
𬇹	goki
哈	hadd
蛤	hacd
铪	hazd
还	hlcu
海	hlkk
嗨	hldk
害	hlwd
氦	hlvk
孩	hlhk
亥	hlkh
嗐	hldd
醢	hlya
骇	hlnk
骸	hlfk
咳	hldk
咍	hldd
胲	hlvk
含	hjjd
喊	hjdd
汉	hjkr
韩	hjng
汗	hjke
寒	hjww
邯	hjzt
函	hjam
憨	hjah
焊	hjce
旱	hjoe
焓	hjcd
悍	hjhe
罕	hjwe
涵	hjkm
翰	hjnz
憾	hjhh
酣	hjyz
撼	hjuh
瀚	hjkz
颔	hjjw
晗	hjod
捍	hjue
蚶	hjcz
鼾	hjoe
扞	hjue
菡	hjlm
邗	hjet
琀	hjnd
暵	hjoh
犴	hjme
顸	hjew
撖	hjuh
浛	hjkd
虷	hjce
㘎	hjdh
垾	hjge
崡	hjvm
嵅	hjvd
蔊	hjle
行	hhpx
杭	hheo
航	hhio
夯	hhms
沆	hhko
颃	hhzw
绗	hhip
巷	hhlv
吭	hhdo
好	hkbh
号	hkda
薅	hklk
耗	hkav
浩	hkkd
豪	hkgj
壕	hkgj
嚎	hkdj
郝	hkgt
蚝	hkcv
皓	hkud
蒿	hklg
毫	hkgv
昊	hkom
皞	hkun
濠	hkkj
灏	hkkw
貉	hkms
鄗	hkgt
淏	hkkm
嗥	hkdn
颢	hkow
镐	hkzg
嚆	hkdg
和	hexd
喝	hedf
核	heek
盒	heja
何	hejz
合	hejd
河	hekz
呵	hedz
贺	heso
鹤	hewx
赫	hegc
荷	helz
禾	hexh
阖	heaa
龁	hela
嗬	hedz
褐	hetf
曷	heof
颌	hejw
郃	hejt
盍	hega
涸	hekc
诃	hesz
鹖	heox
劾	heks
貉	hems
纥	heia
盉	hexa
壑	hegg
吓	hedy
龢	hejx
熇	hecg
菏	helz
饸	heqd
翮	henz
翯	hezg
阂	heak
垎	hegs
隺	hewu
鞨	hetf
𬌗	held
黑	hzph
嘿	hzdp
𬭶	hzzp
很	hfwi
恨	hfhi
狠	hfmi
痕	hfai
𬣳	hfsi
哼	hgdr
横	hgen
恒	hghf
衡	hgpw
亨	hggr
珩	hgnp
桁	hgep
蘅	hglw
鸻	hgpx
姮	hgbf
行	hgpx
堼	hggg
红	hsiu
烘	hsch
宏	hswk
哄	hsdh
轰	hsyr
虹	hscu
洪	hskh
鸿	hskx
薨	hslv
弘	hsbk
泓	hskk
纮	hsik
闳	hsak
吽	hsdq
竑	hsik
黉	hskn
翃	hsnz
訇	hsns
蕻	hslh
唝	hsdo
讧	hssu
荭	hslu
玒	hsnu
谼	hshh
𫟹	hszh
𬭎	hszk
后	hbxd
厚	hbxh
吼	hbda
侯	hbjo
猴	hbmo
候	hbjo
喉	hbdo
齁	hbog
鲎	hbkw
堠	hbgo
垕	hbxg
逅	hbxu
糇	hbpo
瘊	hbao
骺	hbfd
篌	hbro
郈	hbxt
鲘	hbwd
𬭤	hbzo
壶	hugc
户	humh
湖	hukv
胡	hucv
虎	huzh
乎	hutn
糊	hupv
和	huxd
互	hufb
呼	hudn
护	huum
沪	hukm
忽	hunh
弧	huby
狐	humy
唬	hudz
核	huek
斛	huxj
瑚	hunv
瓠	humy
縠	hugr
笏	hure
鹄	huqx
鄠	hutt
葫	hulv
煳	hucv
扈	humm
烀	hucn
祜	hufc
怙	huhc
惚	huhh
觳	hugr
鹘	hufx
岵	huvc
唿	hudh
冱	huwb
鹱	huxr
鳠	huwr
蝴	hucv
琥	hunz
淴	hukh
浒	hukn
鹕	hucx
醐	huyv
槲	huej
滹	hukn
囫	hure
戽	humj
嫭	hubn
轷	huyn
猢	humv
昈	huom
昒	huoe
花	hwlv
化	hwjv
画	hwfm
话	hwsa
滑	hwkf
华	hwjn
划	hwpp
哗	hwdn
桦	hwen
婳	hwbm
骅	hwnn
猾	hwmf
砉	hwam
铧	hwzn
觟	hwxg
坏	hygc
怀	hyhc
淮	hyku
踝	hype
槐	hyea
徊	hywd
换	hrum
还	hrcu
环	hrnc
患	hrdh
幻	hria
缓	hrir
欢	hrre
唤	hrdm
嬛	hrbt
桓	href
寰	hrwt
浣	hrkp
焕	hrcm
獾	hrmu
涣	hrkm
洹	hrkf
圜	hrrt
豢	hrhj
郇	hrnt
鲩	hrwp
奂	hrxm
宦	hrwq
萑	hrlu
逭	hrwu
擐	hrut
缳	hrit
鹮	hryx
澴	hrkt
镮	hrzt
漶	hrkh
鬟	hrpt
睆	hrqp
痪	hram
貆	hrmf
峘	hrvf
锾	hrzr
㬊	hror
荁	hrlf
𤩽	hrnm
𬘫	hrip
黄	hdnh
慌	hdho
皇	hdun
晃	hdom
荒	hdlo
谎	hdso
簧	hdrn
煌	hdcn
篁	hdrn
凰	hdon
幌	hdrm
蝗	hdcn
恍	hdhm
滉	hdkm
遑	hduu
潢	hdkn
璜	hdnn
湟	hdkn
磺	hdmn
肓	hdfv
锽	hdzn
徨	hdwn
惶	hdhn
鳇	hdwn
隍	hdtn
喤	hddn
艎	hdin
癀	hdan
蟥	hdcn
媓	hdbn
瑝	hdnn
㿠	hdum
𨱑	hdzn
会	hvjb
回	hvrd
灰	hvnc
毁	hvpr
汇	hvkn
惠	hvnh
茴	hvld
绘	hvib
挥	hvuy
辉	hvmy
悔	hvhk
慧	hvah
喙	hvdj
晖	hvoy
烩	hvcb
讳	hvsg
恢	hvhc
徽	hvwh
卉	hvnl
虺	hvfc
蕙	hvlh
秽	hvxl
麾	hvzv
晦	hvok
诲	hvsk
隳	hvth
恚	hvgh
荟	hvlb
浍	hvkb
洄	hvkd
翚	hvzy
贿	hvov
翙	hvvz
咴	hvdc
珲	hvny
蛔	hvcd
彗	hvab
哕	hvdl
诙	hvsc
袆	hvtg
橞	hveh
蟪	hvch
桧	hveb
溃	hvko
烠	hvcv
硊	hvmz
㧑	hvui
𬤝	hvsh
𬭬	hvzb
混	hpkv
魂	hpba
婚	hpbo
荤	hply
浑	hpky
昏	hpbo
溷	hpkj
珲	hpny
阍	hpao
馄	hpqv
诨	hpsy
惛	hpho
碈	hpmo
或	hopf
活	hoka
火	hoch
货	hojo
获	holm
霍	hotu
嚯	hodu
祸	hofj
豁	howh
伙	hojc
和	hoxd
惑	hoph
镬	hozr
藿	holu
钬	hozc
濩	hokr
夥	hoql
嚄	hodr
蠖	hocr
攉	houu
漷	hokt
劐	holp
耠	hoad
佸	hoja
锪	hozh
㸌	hocu
𬴃	honm
及	jicj
即	jiiz
级	jiic
机	jieo
既	jiid
集	jiue
记	jisv
鸡	jirx
极	jiec
几	jioj
季	jixh
肌	jivo
基	jizg
急	jixh
系	jiti
继	jiia
挤	jiuq
计	jisn
剂	jiqp
给	jiid
寄	jiwz
姬	jibq
技	jiuc
祭	jihf
吉	jigd
寂	jiwr
籍	jiro
击	jium
纪	jiiv
忌	jivh
己	jivj
积	jixh
暨	jiif
辑	jiyq
脊	jiwv
疾	jiao
戟	jinp
箕	jirh
激	jikh
济	jikq
矶	jimo
叽	jido
迹	jizu
饥	jiqo
绩	jiio
冀	jiah
棘	jiem
藉	jilo
际	jitf
稷	jixh
妓	jibc
汲	jikc
蓟	jilp
伋	jijc
赍	jino
亟	jirf
髻	jipd
殛	jigf
鲫	jiwz
伎	jijc
稽	jixo
偈	jijf
畸	jiqz
霁	jitq
圾	jigc
嫉	jibo
讥	jiso
奇	jimz
笈	jirc
骥	jinh
嵴	jivv
唧	jidz
齑	jiqf
乩	jiya
戢	jidp
玑	jino
畿	jiiq
芰	jilc
嵇	jixv
洎	jiko
罽	jiyp
笄	jirl
楫	jieq
羁	jiyn
跻	jipq
麂	jixo
垍	jigo
姞	jibd
荠	jilq
蕺	jilp
屐	jicc
跽	jiph
觊	jive
漈	jikf
悸	jihh
缉	jiiq
剞	jimp
鲚	jiwq
觭	jixz
佶	jijd
掎	jiuz
岌	jivc
惎	jizh
耤	jiao
虮	jico
芨	jilc
瘠	jiav
期	jizv
蹐	jipv
犄	jiqz
穄	jixf
堲	jiig
蒺	jilo
墼	jiyg
瀱	jikp
鹡	jiwx
鱾	jiwv
㴔	jikh
徛	jiwz
枅	jiel
𪟝	jias
𫌀	jito
𫓯	jizg
𫓹	jizh
𬯀	jitq
𬶨	jiiw
𬶭	jiwf
加	jwsd
家	jwwj
假	jwjr
价	jwjp
甲	jwsj
架	jwse
夹	jwhh
贾	jwvo
嫁	jwbj
佳	jwjg
钾	jwzs
嘉	jwhd
伽	jwjd
驾	jwsn
痂	jwad
镓	jwzj
颊	jwhw
荚	jwlh
枷	jwed
迦	jwsu
葭	jwlr
岬	jwvs
珈	jwnd
斝	jwdj
笳	jwrd
郏	jwht
瘕	jwar
铗	jwzh
戛	jwfp
稼	jwxj
浃	jwkh
茄	jwld
胛	jwvs
槚	jweo
跏	jwpd
蛱	jwch
袈	jwst
恝	jwah
泇	jwkd
𬂩	jweh
间	jmao
见	jmej
件	jmjq
键	jmzu
剑	jmjp
兼	jmhc
建	jmbu
减	jmwd
煎	jmhc
捡	jmuf
箭	jmrp
剪	jmhp
肩	jmmv
简	jmro
尖	jmym
舰	jmie
贱	jmop
健	jmju
碱	jmmd
歼	jmgl
茧	jmlc
监	jmpa
荐	jmlh
溅	jmkp
渐	jmkt
拣	jmuy
检	jmef
僭	jmjo
谏	jmsh
奸	jmbe
坚	jmpg
鉴	jmpz
笺	jmrp
涧	jmko
践	jmpp
蹇	jmwp
艰	jmri
翦	jmhz
菅	jmlk
俭	jmjf
柬	jmxh
缄	jmid
腱	jmvu
笕	jmre
缣	jmic
锏	jmzo
睑	jmqf
戋	jmfp
鞬	jmtu
謇	jmws
湔	jmkp
踺	jmpu
犍	jmqu
裥	jmto
槛	jmea
蒹	jmlc
搛	jmuc
鲣	jmwg
枧	jmee
戬	jmfp
鹣	jmhx
楗	jmeu
暕	jmoh
谫	jmsp
毽	jmvu
趼	jmpl
篯	jmrp
饯	jmqp
鞯	jmth
牮	jmjq
鳒	jmwc
𬣡	jmsp
将	jdak
讲	jdsq
奖	jdam
酱	jday
姜	jdgb
江	jdku
降	jdtv
蒋	jdlk
僵	jdjf
匠	jdnt
桨	jdae
浆	jdak
犟	jdbq
绛	jdiv
疆	jdbf
缰	jdif
鳉	jdwk
豇	jdzu
洚	jdkv
强	jdbc
耩	jdag
弶	jdby
虹	jdcu
糨	jdpc
礓	jdmf
茳	jdlu
膙	jdvc
叫	jcdi
交	jcab
较	jcyb
教	jcqh
脚	jcvz
角	jcxt
胶	jcvb
浇	jckp
缴	jcih
焦	jcuc
搅	jcue
嚼	jcdk
窖	jced
椒	jcer
娇	jcbp
绞	jcib
跤	jcpb
鲛	jcwb
轿	jcyp
矫	jcop
剿	jcop
蛟	jccb
徼	jcwh
骄	jcnp
礁	jcmc
饺	jcqb
蕉	jclc
铰	jczb
狡	jcmb
皎	jcub
郊	jcat
湫	jckc
姣	jcbb
酵	jcyh
滘	jckd
校	jceb
鹪	jcux
醮	jcyc
皦	jcuh
觉	jcke
敫	jcuh
艽	jclk
茭	jclb
峤	jcvp
佼	jcjb
璬	jcnh
燋	jccc
侥	jcjp
斠	jcqj
皭	jcuk
峧	jcvb
藠	jclu
噍	jcdc
漖	jckh
僬	jcjc
恔	jchb
䴔	jcax
届	jxcd
界	jxqp
接	jxub
借	jxjo
皆	jxvu
解	jxxq
节	jxlz
姐	jxbf
街	jxpg
结	jxid
截	jxnu
杰	jxec
劫	jxgs
戒	jxpl
阶	jxtp
揭	jxuf
介	jxjp
蚧	jxcp
洁	jxkd
捷	jxus
芥	jxlp
藉	jxlo
嗟	jxdu
诘	jxsd
羯	jxgf
桀	jxle
竭	jxif
价	jxjp
桔	jxed
颉	jxgw
疖	jxaz
孑	jxrf
诫	jxsl
婕	jxbs
玠	jxnp
疥	jxap
睫	jxqs
碣	jxmf
絜	jxai
劼	jxgs
秸	jxxd
拮	jxud
檞	jxeq
骱	jxfp
湝	jxku
楷	jxeu
蜐	jxcs
鲒	jxwd
讦	jxse
喈	jxdu
悈	jxhl
褯	jxtr
岊	jxmv
㛃	jxab
进	jnqu
近	jntu
仅	jnjr
金	jnzj
斤	jntj
今	jnja
尽	jncw
劲	jnrs
紧	jnpi
晋	jnfo
禁	jnef
筋	jnrs
津	jnkb
巾	jnrj
锦	jnzr
浸	jnkr
堇	jnla
谨	jnsa
靳	jntt
槿	jnea
衿	jnta
瑾	jnna
烬	jncw
襟	jntf
矜	jnia
瑨	jnno
噤	jndf
溍	jnko
缙	jnio
觐	jnle
祲	jnfr
妗	jnba
馑	jnqa
浕	jnkw
赆	jnow
荩	jnlw
殣	jnga
珒	jnnb
廑	jnxa
琎	jnnu
墐	jnga
卺	jnaz
𬬱	jnzt
经	jyiu
竟	jyxp
精	jypv
镜	jyzp
净	jywb
静	jyab
竞	jyip
景	jyoy
井	jyqj
敬	jylh
京	jygy
鲸	jywy
惊	jyhy
颈	jyrw
警	jyls
境	jygp
茎	jylu
荆	jylp
径	jywu
靖	jyiv
菁	jylv
晶	jyoo
睛	jyqv
璟	jyny
胫	jyvu
粳	jypb
阱	jytq
劲	jyrs
旌	jyll
肼	jyvq
泾	jyku
丼	jyqi
婧	jybv
竫	jyib
迳	jyru
儆	jyjh
腈	jyvv
憬	jyhy
痉	jyau
倞	jyjy
刭	jyrp
靓	jyae
獍	jymp
兢	jycp
鼱	jypv
汫	jykq
璥	jynh
麖	jyxy
猄	jymy
䴖	jyax
囧	jsrm
冏	jsmd
炯	jscd
迥	jsmu
窘	jsed
扃	jsmd
颎	jsvw
炅	jsoc
坰	jsgd
泂	jskd
䌹	jsid
𬳶	jsnd
就	jqgo
酒	jqky
旧	jqgo
救	jqfh
九	jqkj
久	jqxi
揪	jquc
灸	jqxc
鸠	jqkx
啾	jqdc
玖	jqni
韭	jqrf
纠	jqii
舅	jqps
究	jqek
咎	jqhd
臼	jqpj
鹫	jqgx
厩	jqxd
僦	jqjo
柩	jqei
疚	jqai
氿	jqkk
鬏	jqpc
阄	jqaw
赳	jqpi
桕	jqep
㠇	jqvo
据	juuc
剧	jucp
局	jucd
句	jugj
举	juku
距	jupn
聚	juqk
巨	junn
居	jucc
具	juqh
拒	juun
狙	jumf
俱	jujh
菊	julp
锯	juzc
焗	jucd
橘	jued
车	juyc
惧	juhh
車	juyc
矩	juon
钜	juzn
鞠	jutp
遽	juzu
拘	juug
沮	jukf
驹	jung
莒	juld
掬	juup
踞	jupc
桔	jued
锔	juzd
苴	julf
炬	jucn
讵	jusn
咀	judf
琚	junc
裾	jutc
椐	juec
鞫	juts
秬	juxn
屦	jucb
倨	jujc
雎	jufu
娵	jubr
苣	juln
疽	juaf
榉	jueu
筥	jurd
蒟	julg
窭	jueb
醵	juyj
飓	juoh
龃	julf
崌	juvc
柜	juen
泃	jukg
砠	jumf
踽	jupv
犋	juqh
岨	juvf
枸	jueg
趄	jupf
澽	jukj
岠	juvn
腒	juvc
弆	jugl
䴗	juqx
𬶋	juwg
卷	jrhz
捐	jruv
圈	jrrz
绢	jriv
涓	jrkv
娟	jrbv
倦	jrjz
隽	jruv
狷	jrmv
镌	jrzv
蠲	jrkc
鹃	jrdx
鄄	jrvt
眷	jrhq
焆	jrcv
锩	jrzz
桊	jrhe
绝	jtim
觉	jtke
嚼	jtdk
决	jtwj
撅	jtue
倔	jtjm
爵	jtyk
掘	jtum
角	jtxt
厥	jtxe
诀	jtsj
珏	jtni
玦	jtnj
蕨	jtle
蹶	jtpe
噘	jtde
崛	jtvm
攫	jtur
谲	jtsd
橛	jtee
抉	jtuj
傕	jtju
玃	jtmr
爝	jtck
孓	jtri
桷	jtet
觖	jtxj
矍	jtqr
獗	jtme
镢	jtze
劂	jtxp
砄	jtmj
㵐	jtke
𫔎	jtzd
𫘝	jtnj
均	jpgw
君	jpbd
军	jpwy
郡	jpbt
菌	jplx
俊	jpjh
钧	jpzw
峻	jpvh
骏	jpnh
浚	jpkh
珺	jpnd
畯	jpqh
竣	jpih
麇	jpxx
焌	jpch
皲	jpwr
晙	jpoh
莙	jpld
筠	jprw
捃	jpud
龟	jpwg
隽	jpuv
葰	jplh
鲪	jpwd
䐃	jpvx
卡	kayy
咯	kads
咖	kadd
咔	kady
喀	kads
胩	kavy
开	klfl
凯	klvo
铠	klzv
恺	klhv
揩	kluu
楷	kleu
锎	klzl
慨	klhd
闿	klav
锴	klzu
忾	klhv
垲	klgv
炌	klcp
剀	klvp
蒈	kllu
看	kjuq
砍	kjme
坎	kjge
刊	kjep
堪	kjga
槛	kjea
侃	kjjo
勘	kjzs
龛	kjjt
阚	kjah
戡	kjzp
瞰	kjqh
莰	kjle
衎	kjpe
磡	kjms
崁	kjve
嵁	kjva
墈	kjgs
抗	khuo
扛	khuu
康	khxk
炕	khco
糠	khpk
钪	khzo
慷	khhk
亢	khzo
伉	khjo
闶	khao
𡐓	khgk
𩾌	khwk
靠	kkqr
考	kkqa
烤	kkca
拷	kkua
尻	kkck
铐	kkza
犒	kkqg
栲	kkea
洘	kkka
㸆	kkcr
可	kezk
课	kese
克	kecp
科	kexj
客	kews
氪	kevp
颗	keqw
壳	kego
磕	kema
刻	kekp
咳	kedk
柯	keez
嗑	keda
珂	kenz
棵	keee
渴	kekf
恪	kehs
颏	kekw
苛	kelz
窠	keee
轲	keyz
髁	kefe
疴	keaz
瞌	keqa
坷	kegz
蝌	kecj
缂	keit
锞	keze
骒	kene
炣	kecz
岢	kevz
溘	keka
稞	kexe
匼	kend
牁	keaz
剋	kzcp
啃	kfdv
肯	kfsv
垦	kfig
恳	kfih
裉	kfti
坑	kggo
吭	kgdo
铿	kgzg
硁	kgmu
空	kseu
孔	ksha
控	ksuu
恐	ksuh
崆	ksvu
硿	ksmu
箜	ksru
倥	ksju
埪	ksgu
口	kbdk
扣	kbud
抠	kbub
寇	kbwh
叩	kbdz
蔻	kblh
芤	kbla
筘	kbrd
眍	kbqb
𫸩	kbbb
库	kuxy
哭	kudm
苦	kulc
酷	kuyd
裤	kuty
枯	kuec
窟	kuem
喾	kukd
刳	kump
骷	kufc
绔	kuia
矻	kuma
圐	kurl
跨	kwpa
夸	kwma
垮	kwga
胯	kwva
挎	kwua
侉	kwja
姱	kwba
快	kyhj
块	kygj
会	kyjb
筷	kyrj
哙	kydb
脍	kyvb
郐	kyjt
侩	kyjb
蒯	kylp
鲙	kywb
浍	kykb
狯	kymb
㧟	kyun
款	krge
宽	krwe
髋	krfe
狂	kdmn
框	kden
矿	kdmx
筐	kdrn
况	kdwp
哐	kddn
匡	kdnn
旷	kdox
诓	kdsn
邝	kdxt
诳	kdsn
眶	kdqn
圹	kdgx
贶	kdop
纩	kdix
夼	kdmo
洭	kdkn
𫛭	kdmx
亏	kvma
奎	kvmg
窥	kvee
蝰	kvcg
盔	kvna
葵	kvlm
夔	kvhh
魁	kvaj
匮	kvno
愧	kvha
溃	kvko
揆	kvum
馈	kvqo
逵	kvgu
愦	kvho
傀	kvja
睽	kvqm
櫆	kvej
馗	kvko
骙	kvnm
聩	kvqo
跬	kvpg
煃	kvcg
悝	kvhd
戣	kvhp
喟	kvdv
喹	kvdg
蒉	kvlo
篑	kvro
岿	kvvb
暌	kvom
𫠆	kvcw
困	kpre
坤	kpgg
捆	kpue
昆	kpov
鲲	kpwv
堃	kplg
琨	kpnv
髡	kppp
鹍	kpox
焜	kpcv
阃	kpae
醌	kpyv
悃	kphe
锟	kpzv
壸	kpgc
裈	kpty
婫	kpbv
扩	koux
阔	koaa
括	koua
廓	koxt
蛞	koca
啦	ladi
拉	laui
辣	lanx
剌	laxp
蜡	laco
腊	lavo
喇	ladp
菈	lali
垃	lagi
落	lals
邋	laou
镴	lazp
旯	laok
蝲	lacp
揦	laup
瘌	laap
砬	lami
鞡	lati
𬶟	lawp
来	llah
莱	lllh
赖	llxo
铼	llzh
濑	llko
赉	llao
徕	llwh
癞	llao
涞	llkh
睐	llqh
崃	llvh
籁	llro
俫	lljh
梾	lleh
烂	ljct
蓝	ljla
懒	ljho
兰	ljht
栏	ljet
揽	ljue
拦	ljut
篮	ljra
岚	ljvb
滥	ljka
览	ljpe
澜	ljkh
榄	ljee
阑	ljah
镧	ljzh
缆	ljie
婪	ljeb
褴	ljta
斓	ljvh
谰	ljsh
罱	ljyg
襕	ljth
漤	ljkb
𬒗	ljme
狼	lhmi
浪	lhki
郎	lhit
朗	lhiv
廊	lhxt
啷	lhdt
琅	lhni
烺	lhci
螂	lhct
崀	lhvi
阆	lhai
锒	lhzi
榔	lhet
桹	lhei
埌	lhgi
塱	lhig
莨	lhli
蒗	lhli
稂	lhxi
筤	lhri
㫰	lhoi
㮾	lhie
蓢	lhlv
老	lkql
捞	lkus
佬	lkjq
唠	lkds
劳	lkls
牢	lkwq
烙	lkcs
铑	lkzq
姥	lkbq
涝	lkks
醪	lkye
酪	lkys
落	lkls
痨	lkas
铹	lkzs
嫪	lkbe
崂	lkvs
栳	lkeq
荖	lklq
络	lkis
耢	lkas
𫭼	lkgs
了	lerl
乐	leby
勒	lets
叻	leds
仂	lejs
鳓	lews
簕	lers
饹	leqs
泐	leks
嘞	leds
类	lzpm
累	lzqi
雷	lztq
泪	lzkq
嘞	lzds
垒	lzkg
勒	lzts
蕾	lzlq
镭	lzzq
肋	lzvs
磊	lzmm
擂	lzuq
罍	lzqa
诔	lzsa
羸	lzfi
酹	lzyk
耒	lzal
嫘	lzbi
缧	lzii
儡	lzjq
藟	lzlq
檑	lzeq
礌	lzmq
癗	lzaq
冷	lgwk
楞	lgel
愣	lghl
棱	lgeh
崚	lgvh
塄	lggl
堎	lggh
里	lidl
离	lizv
力	lisl
李	lieh
例	lijp
利	lixp
理	lind
立	liil
礼	lifa
粒	lipi
梨	lixe
历	lixs
锂	lizd
丽	lifv
哩	lirg
黎	lixk
栗	live
莉	lilp
吏	lifb
戾	limm
藜	lilk
鲤	liwd
厘	lixd
笠	liri
犁	lixq
璃	linv
狸	limd
厉	lixp
隶	libk
栎	liey
骊	linv
荔	lils
沥	liks
俪	lijv
励	lixs
砾	limy
醴	liyz
砺	limp
澧	likz
詈	liys
鬲	ling
痢	liap
罹	liyu
疠	liap
莅	lili
俚	lijd
郦	lift
喱	lidd
篱	lirv
鳢	liwz
漓	likv
浬	lieg
轹	liyy
俐	lijp
蓠	lilv
蛎	licp
蠡	libc
唳	lidm
呖	lids
溧	like
蜊	licp
鲡	liwv
醨	liyv
嫠	liab
凓	liwe
枥	lies
逦	lifu
娌	libd
粝	lipp
鹂	lifx
苈	lils
黧	lixp
缡	liiv
傈	lije
坜	ligs
疬	lias
跞	lipy
朸	lies
珕	lins
浰	likp
雳	lits
猁	limp
篥	lire
㰀	liek
𫵷	livs
𬍛	liny
俩	lwjm
连	lmyu
练	lmiy
脸	lmvf
链	lmzu
联	lmqm
恋	lmzh
莲	lmlu
帘	lmer
炼	lmcy
镰	lmzc
敛	lmjh
怜	lmhk
廉	lmxc
涟	lmku
濂	lmkc
殓	lmgf
蠊	lmcc
琏	lmnu
楝	lmeh
鲢	lmwu
奁	lmmb
蔹	lmlh
裢	lmtu
潋	lmkh
梿	lmeu
浰	lmkp
裣	lmtf
瑓	lmnh
𬶠	lmwh
量	ldod
两	ldml
亮	ldgo
梁	ldke
辆	ldym
凉	ldwy
粮	ldpi
良	ldii
晾	ldoy
靓	ldae
俩	ldjm
谅	ldsy
粱	ldkp
椋	ldey
俍	ldji
魉	ldam
墚	ldge
莨	ldli
踉	ldpi
辌	ldyy
悢	ldhi
𫟅	ldiy
𬜯	ldlm
聊	lcqb
撩	lcuy
料	lcpj
辽	lcru
廖	lcxe
撂	lcus
寮	lcwy
疗	lcar
蓼	lcle
瞭	lcqy
钌	lczr
燎	lccy
了	lcrl
獠	lcmy
潦	lcky
僚	lcjy
憭	lchy
髎	lcfe
寥	lcwe
嘹	lcdy
橑	lcey
嫽	lcby
缭	lciy
镣	lczy
尥	lcoi
蹽	lcpy
漻	lcke
鹩	lcmx
簝	lcry
𪤗	lcge
列	lxgp
咧	lxdp
猎	lxmo
烈	lxgc
裂	lxgt
劣	lxys
鬣	lxpp
洌	lxkp
冽	lxwp
埒	lxgk
躐	lxpp
捩	lxum
趔	lxpp
峛	lxvp
脟	lxvk
䴕	lxgx
𫚭	lxwp
林	lnee
拎	lnuk
临	lnpo
磷	lnmv
琳	lnne
凛	lnwf
淋	lnke
霖	lnte
鳞	lnwv
邻	lnjt
麟	lnxv
璘	lnnv
廪	lnxf
赁	lnjo
蔺	lnlu
吝	lnvd
檩	lnef
懔	lnhf
膦	lnvv
潾	lnkv
粼	lnpo
嶙	lnvv
躏	lnpu
啉	lnde
遴	lnpu
辚	lnyv
箖	lnre
瞵	lnqv
翷	lnpz
𬭸	lnzv
𬴊	lnnv
另	lyds
令	lyjk
零	lytk
领	lyjw
铃	lyzk
灵	lybc
玲	lynk
岭	lyvk
陵	lyth
凌	lywh
龄	lylk
绫	lyih
翎	lyjz
聆	lyqk
泠	lykk
澪	lykk
伶	lyjk
蛉	lyck
菱	lylh
苓	lylk
姈	lybk
羚	lygk
呤	lydk
瓴	lyjr
棂	lyec
祾	lyfh
鲮	lywh
舲	lyik
棱	lyeh
酃	lytt
坽	lygk
囹	lyrk
柃	lyek
〇	lydk
鸰	lyjx
昤	lyok
㥄	lyhh
六	lqal
留	lqbq
流	lqko
刘	lqvp
溜	lqkq
柳	lqeb
硫	lqmo
遛	lqbu
瘤	lqaq
镠	lqze
琉	lqno
熘	lqcq
浏	lqkp
绺	lqid
榴	lqeq
旒	lqlo
陆	lqtm
鎏	lqkz
骝	lqnq
馏	lqqq
镏	lqzq
锍	lqzo
珋	lqnb
疁	lqqe
罶	lqyq
鹨	lqzx
瑬	lqki
飗	lqoq
碌	lqmk
鹠	lqbx
咯	lods
龙	lstl
隆	lstl
泷	lskt
拢	lsut
笼	lsrt
陇	lstt
聋	lstq
珑	lsnt
胧	lsvt
垄	lstg
茏	lslt
栊	lset
砻	lstm
咙	lsdt
哢	lsdl
癃	lsal
窿	lsel
昽	lsot
弄	lsnl
漋	lskl
眬	lsqt
𬕂	lsro
楼	lbeb
喽	lbdb
漏	lbkt
搂	lbub
娄	lbpb
瘘	lbab
露	lbts
篓	lbrb
镂	lbzb
陋	lbta
蒌	lblb
耧	lbab
蝼	lbcb
偻	lbjb
溇	lbkb
髅	lbfb
嵝	lbvb
䁖	lbqb
剅	lbzp
𦝼	lbvb
𪣻	lbgb
路	lups
录	lubk
撸	luuo
陆	lutm
鲁	luwo
鹿	luxl
卢	luyc
露	luts
卤	luyb
炉	lucm
虏	luzs
噜	ludo
麓	luex
掳	luus
禄	lufk
戮	luzp
庐	luxm
垆	lugc
橹	lueo
璐	luns
芦	lulm
潞	luks
颅	luyw
泸	lukc
鹭	lupx
胪	luvc
渌	lukk
镥	luzo
赂	luos
鲈	luwc
菉	lulk
簏	lurx
蕗	luls
碌	lumk
漉	lukx
僇	luje
栌	luec
箓	lurk
辂	luys
舻	luic
琭	lunk
辘	luyx
逯	lubu
鸬	luyx
甪	lutt
绿	luik
轳	luyc
勠	luzs
澛	luko
氇	luvo
稑	luxg
𫘧	lunk
𬬻	luzc
乱	lraa
卵	lrbl
鸾	lrzx
栾	lrze
銮	lrzz
峦	lrzv
娈	lrzb
挛	lrzu
脔	lrzj
孪	lrzh
滦	lrke
论	lpsj
轮	lpyj
抡	lpuj
伦	lpjj
仑	lpjl
纶	lpij
沦	lpkj
囵	lprj
𫭢	lpgj
𬬭	lpzj
罗	loyl
落	lols
咯	lods
洛	loks
裸	lote
啰	lodl
骆	lons
摞	loui
螺	loci
络	lois
骡	loni
锣	lozl
萝	loll
雒	losu
珞	lons
逻	loyu
蠃	lofi
箩	lorl
烙	locs
泺	loky
荦	lolq
漯	loki
捋	louk
倮	loje
椤	loel
瘰	loai
猡	loml
蓏	loly
脶	lovj
率	lvzn
绿	lvik
铝	lvzd
吕	lvdd
驴	lvnm
旅	lvlt
律	lvwb
捋	lvuk
氯	lvvk
屡	lvcb
滤	lvkh
虑	lvzh
履	lvch
缕	lvib
侣	lvjd
闾	lvad
膂	lvlv
梠	lved
榈	lved
褛	lvtb
偻	lvjb
稆	lvxd
葎	lvlb
垏	lvgb
𦝼	lvvb
略	ltqs
掠	ltuy
锊	ltzk
圙	ltrb
䂮	ltam
吗	madn
嘛	madz
骂	madn
马	manm
码	mamn
妈	mabn
麻	mazm
玛	mann
蚂	macn
抹	maue
蟆	macm
祃	mafn
犸	mamn
摩	mazu
杩	maen
买	mlam
卖	mlnm
麦	mlah
埋	mlgd
迈	mlfu
脉	mlvk
霾	mltd
唛	mldh
劢	mlfs
荬	mllm
鿏	mlzh
慢	mjhr
满	mjkm
蛮	mjzc
曼	mjor
漫	mjkr
螨	mjcm
瞒	mjqm
蔓	mjlr
幔	mjrr
鳗	mjwr
缦	mjir
馒	mjqr
谩	mjsr
鬘	mjpr
墁	mjgr
嫚	mjbr
镘	mjzr
颟	mjlw
鞔	mjtp
埋	mjgd
𬜬	mjld
忙	mhhf
盲	mhfq
莽	mhll
芒	mhlf
氓	mhfd
蟒	mhcl
茫	mhlf
邙	mhft
漭	mhkl
尨	mhoe
牻	mhqe
牤	mhqf
厖	mhxe
杧	mhef
硭	mhmf
猫	mkmq
毛	mkvm
冒	mkoq
帽	mkrq
锚	mkzq
贸	mkbo
矛	mkit
卯	mkbm
茅	mklt
貌	mkmp
昴	mkob
茂	mkln
冇	mknm
旄	mklv
峁	mkvb
髦	mkpv
铆	mkzb
耄	mkqv
楙	mkee
懋	mkeh
芼	mklv
瑁	mknq
牦	mkqv
茆	mklb
袤	mktt
瞀	mkiq
泖	mkkb
眊	mkqv
鄚	mklt
蝥	mkic
蟊	mkic
么	metk
没	mzkr
每	mzek
美	mzgm
枚	mzeh
梅	mzek
酶	mzyk
妹	mzba
煤	mzce
霉	mztk
镁	mzzm
眉	mzcq
魅	mzaa
玫	mznh
媚	mzbq
昧	mzoa
媒	mzbe
莓	mzlk
镅	mzzq
郿	mzct
寐	mzwa
湄	mzkq
浼	mzkp
袂	mztj
楣	mzeq
鹛	mzcx
渼	mzkm
瑂	mznq
糜	mzzp
媄	mzbm
嵋	mzvq
们	mfja
门	mfam
焖	mfch
闷	mfah
扪	mfua
钔	mfza
呇	mfkd
懑	mfkh
𫞩	mfnm
梦	mgel
猛	mgma
萌	mglv
蒙	mglj
懵	mghq
孟	mgha
锰	mgza
盟	mgoa
濛	mgkj
獴	mgmj
勐	mghs
虻	mgcf
檬	mgej
蠓	mgcj
甍	mglr
艋	mgia
朦	mgvj
瞢	mglq
幪	mgrj
艨	mgij
蜢	mgca
礞	mgmj
㠓	mgvj
鹲	mglx
𫑡	mgdt
米	mipm
迷	mipu
密	miwv
谜	misu
蜜	miwc
咪	midp
弥	miby
觅	miye
幂	miwr
蘼	milr
芈	migy
秘	mixt
靡	mizr
眯	miqp
糜	mizp
醚	miyu
祕	mift
祢	mify
弭	mibq
麋	mixp
泌	mikt
汨	miko
宓	miwt
谧	misa
脒	mivp
蓂	mila
醾	miyp
縻	mizi
猕	mimy
敉	miph
洣	mikp
嘧	midv
面	mmbm
免	mmwp
棉	mmer
眠	mmqd
缅	mmib
绵	mmir
勉	mmws
冕	mmop
沔	mmka
眄	mmqa
丏	mmfa
勔	mmbs
愐	mmhb
娩	mmbp
湎	mmkb
腼	mmvb
偭	mmjb
渑	mmkd
𩾃	mmwp
秒	mcxt
喵	mcdq
庙	mcxd
妙	mcbt
瞄	mcqq
苗	mclq
描	mcuq
淼	mckk
渺	mckt
眇	mcqt
缈	mcit
杪	mcet
邈	mcmu
藐	mclp
缪	mcie
鹋	mclx
灭	mxfc
咩	mxdg
乜	mxaa
蔑	mxli
篾	mxri
民	mndm
敏	mneh
皿	mnam
抿	mnud
闽	mnac
泯	mnkd
闵	mnav
缗	mnio
旻	mnov
愍	mndh
湣	mnko
珉	mnnd
悯	mnhv
岷	mnvd
鳘	mnew
黾	mndm
忞	mnvh
苠	mnld
名	myld
命	myjz
明	myov
鸣	mydx
茗	myld
冥	mywa
铭	myzd
暝	myoa
洺	mykd
溟	myka
瞑	myqa
酩	myyd
螟	myca
谬	mqse
缪	mqie
莫	molm
磨	mozm
魔	moza
摸	moum
膜	movm
末	mofe
抹	moue
麽	mozk
墨	mopg
没	mokr
摩	mozu
默	mopm
模	moem
馍	moqm
沫	moke
摹	molu
殁	mogr
陌	motu
茉	mole
谟	mosm
貘	momm
漠	mokm
貊	momu
镆	mozm
蘑	molm
秣	moxe
蓦	moln
寞	mowm
万	mofp
瘼	moam
嬷	mobk
耱	moam
无	modu
脉	movk
嫫	mobm
靺	mote
藦	molu
𬙊	moig
某	mbze
谋	mbse
牟	mbkq
缪	mbie
眸	mbqq
哞	mbdq
侔	mbjq
鍪	mbiz
蛑	mbcq
木	muem
目	muqm
墓	mulg
姆	mubk
母	mukm
穆	muxe
沐	muke
亩	muzq
牧	muqh
暮	mulo
模	muem
慕	mulh
幕	mulr
钼	muzq
募	muls
拇	muuk
睦	muqg
牡	muqg
呒	mudd
苜	mulq
牟	mukq
仫	mujk
毪	muvq
𧿹	mupk
𬭁	muzk
那	naat
拿	naju
哪	nadt
呐	nadj
娜	nabt
纳	naij
钠	nazj
捺	nauf
镎	nazu
衲	natj
乸	naek
南	nang
肭	navj
𦰡	nalt
乃	nlvn
奶	nlbv
耐	nllk
奈	nlmf
氖	nlvv
萘	nllf
柰	nlef
迺	nlvu
艿	nllv
鼐	nlva
耏	nlle
佴	nljq
难	njru
男	njqs
南	njng
楠	njeg
喃	njdg
腩	njvg
囡	njrb
赧	njgr
蝻	njcg
婻	njbg
萳	njlg
囊	nhnt
馕	nhqt
曩	nhof
攮	nhut
齉	nhot
囔	nhdt
脑	nkvm
闹	nkar
挠	nkup
恼	nkhm
淖	nkkn
瑙	nknb
孬	nkch
铙	nkzp
垴	nkgm
呶	nkdr
猱	nkme
臑	nkvl
蛲	nkcp
硇	nkmb
峱	nkmv
呢	nedv
讷	nesj
哪	nedt
内	nzmj
馁	nzqb
嫩	nfbh
恁	nfjh
能	ngkv
你	nijy
尼	nicv
逆	nihu
泥	nikv
拟	niuj
匿	nind
腻	nivo
妮	nibv
倪	nijp
呢	nidv
溺	nikw
铌	nizv
昵	niov
霓	nitp
睨	niqp
伲	nijv
鲵	niwp
猊	nimp
旎	nilv
麑	nixp
坭	nigv
怩	nihv
薿	nilt
𨺙	nitp
𫐐	niyp
𫠜	nilp
年	nmev
念	nmjh
黏	nmxd
碾	nmmt
撵	nmuy
捻	nmuh
辇	nmhy
蔫	nmlc
鲶	nmwh
拈	nmud
廿	nmln
鲇	nmwd
埝	nmgh
粘	nmpd
娘	ndbi
酿	ndyi
嬢	ndbf
鸟	ncxn
尿	ncck
茑	nclx
脲	ncvk
袅	ncxt
捏	nxug
镍	nxze
涅	nxkg
聂	nxqr
孽	nxlh
镊	nxzr
颞	nxqw
蹑	nxpr
臬	nxoe
啮	nxdl
蘖	nxle
嗫	nxdr
乜	nxaa
嵲	nxve
菍	nxlh
糵	nxlp
陧	nxtg
𫔶	nxae
您	nnjh
拧	nyua
宁	nywa
凝	nywt
甯	nywt
狞	nyma
柠	nyea
苧	nyla
佞	nyjb
泞	nyka
咛	nyda
聍	nyqa
牛	nqqn
扭	nqug
妞	nqbg
纽	nqig
钮	nqzg
拗	nqus
狃	nqmg
杻	nqeg
忸	nqhg
弄	nsnl
浓	nskt
农	nswt
侬	nsjt
脓	nsvt
秾	nsxt
哝	nsdt
𬪩	nsyt
耨	nbak
怒	nubh
努	nubs
弩	nubb
奴	nubr
驽	nubn
傉	nujk
孥	nubh
砮	nubm
胬	nubj
笯	nurr
暖	nror
诺	nosd
挪	nout
糯	nopl
喏	nodd
傩	noju
懦	nohl
搦	nouw
锘	nozd
娜	nobt
𦰡	nolt
女	nvbn
钕	nvzb
衄	nvtg
恧	nvlh
虐	ntzb
疟	ntab
哦	oodp
噢	oodm
喔	oody
欧	oune
藕	oulv
偶	oujv
呕	oudb
区	ounb
鸥	ounx
沤	oukb
殴	ounr
耦	ouav
讴	ousb
瓯	ounr
怄	ouhb
𠙶	ourm
𬉼	oucb
怕	pahu
爬	paym
趴	paph
啪	padu
帕	paru
扒	pauh
耙	paam
葩	palm
琶	panm
杷	paem
舥	paim
潖	pakm
筢	parm
拍	pluu
派	plkt
牌	plan
排	plur
湃	plka
俳	pljr
徘	plwr
哌	pldt
迫	pluu
蒎	pllt
簰	plrn
盘	pjia
判	pjhp
潘	pjkq
畔	pjqu
攀	pjeu
盼	pjqp
叛	pjhr
爿	pjap
磐	pjim
袢	pjtu
槃	pjie
蟠	pjcq
泮	pjku
襻	pjtu
胖	pjvu
番	pjtq
磻	pjmq
蹒	pjpm
旁	phil
胖	phvu
庞	phxt
彷	phwl
磅	phml
滂	phkl
乓	phti
逄	phhu
螃	phcl
耪	phal
雱	phtl
鳑	phwl
膀	phvl
跑	pkpv
泡	pkkv
炮	pkcv
抛	pkus
刨	pknp
袍	pktv
匏	pkmv
庖	pkxv
咆	pkdv
狍	pkmv
疱	pkav
脬	pkvh
配	pzyv
赔	pzod
陪	pztd
佩	pzjr
呸	pzdf
胚	pzvf
裴	pzrt
培	pzgd
醅	pzyd
珮	pznr
沛	pzkr
辔	pzid
旆	pzlr
锫	pzzd
帔	pzrr
霈	pztr
衃	pztc
喷	pfdo
盆	pfha
湓	pfka
捧	pguu
碰	pgmc
彭	pghe
砰	pgmh
棚	pgev
硼	pgmv
朋	pgvv
鹏	pgvx
烹	pggc
嘭	pgde
蓬	pglu
膨	pgve
篷	pgru
澎	pgke
芃	pgli
抨	pguh
椪	pgec
怦	pghh
弸	pgbv
堋	pggv
淜	pgkv
蟛	pgce
搒	pgul
皮	pirp
屁	picv
批	piuv
劈	picp
匹	pinp
啤	pidn
脾	pivn
癖	pian
披	piur
辟	picn
铍	pizr
丕	picf
疲	piar
毗	piqv
痞	piad
坯	pigf
嚭	pihd
僻	pijn
罴	piyc
譬	pics
噼	pidn
琵	pinv
貔	pimv
蜱	picn
圮	pigv
陂	pitr
邳	pict
郫	piut
伾	pijf
裨	pitn
霹	pitn
媲	pibv
鼙	pihn
陴	pitn
甓	picr
睥	piqn
埤	pign
淠	pikl
椑	pien
狉	pimf
澼	pikn
枇	piev
砒	pimv
蚍	picv
纰	piiv
仳	pijv
否	picd
鲏	piwr
䴙	picx
苉	pilp
𬳵	pinf
篇	pmri
偏	pmji
片	pmap
骗	pmni
骈	pmnl
便	pmjb
谝	pmsi
翩	pmmz
楩	pmeb
扁	pmmi
胼	pmvl
蹁	pmpi
犏	pmqi
㛹	pmbb
𡎚	pmgi
票	pcvf
飘	pcvb
漂	pckf
嫖	pcbf
瞟	pcqf
瓢	pcvy
剽	pcvp
缥	pcif
骠	pcnf
朴	pcey
殍	pcgh
薸	pclf
嘌	pcdf
蔈	pclf
螵	pccf
撇	pxuh
瞥	pxfq
氕	pxvt
苤	pxlf
𬭯	pxzh
拼	pnul
品	pndd
频	pnsw
贫	pnho
聘	pnqa
嫔	pnbh
颦	pnsn
牝	pnqv
姘	pnbl
玭	pnnv
𬞟	pnlw
屏	pycl
平	pyeh
凭	pyjo
瓶	pyhr
评	pysh
坪	pygh
萍	pylh
枰	pyeh
乒	pytt
苹	pylh
娉	pyba
鲆	pywh
俜	pyja
冯	pywn
洴	pykl
泙	pykh
玶	pynh
涄	pyka
帡	pyrl
荓	pyll
蚲	pych
破	pomr
颇	porw
坡	pogr
泼	poki
婆	pokb
迫	pouu
珀	ponu
钋	pozy
魄	poua
钷	pozd
泊	poku
粕	popu
鄱	pott
皤	pouq
叵	pond
酦	poyi
陂	potr
桲	poeh
朴	poey
繁	poei
笸	pord
䥽	pozi
剖	pbip
裒	pbtp
掊	pbud
抔	pbuc
谱	puso
铺	puzn
普	puho
扑	puuy
噗	pudi
朴	puey
葡	puln
蒲	puln
璞	puni
仆	pujy
浦	pukn
濮	puki
莆	puln
溥	pukk
瀑	pukk
圃	purn
蹼	pupi
曝	puok
埔	pugn
镤	puzi
堡	pujg
镨	puzo
菩	puld
酺	puyn
匍	punn
蒱	puln
潽	puko
脯	puvn
墣	pugi
氆	puvo
穙	puxi
其	qizh
起	qipv
期	qizv
七	qirq
气	qivq
器	qidd
骑	qinz
齐	qiqq
棋	qieh
漆	qikk
奇	qimz
弃	qibl
旗	qilh
妻	qifb
绮	qiiz
欺	qize
岂	qivv
琪	qinh
砌	qimp
启	qimd
企	qijs
契	qiam
淇	qikh
泣	qiki
琦	qinz
栖	qiev
鳍	qiwo
乞	qiea
祁	qift
戚	qiny
祇	qifb
麒	qixh
炁	qidc
汽	qikv
沏	qikp
柒	qike
祈	qift
祺	qifh
讫	qisa
脐	qivq
崎	qivz
岐	qivc
蕲	qilt
迄	qieu
杞	qiev
萁	qilh
嘁	qidy
欹	qime
锜	qizz
凄	qiwb
槭	qiey
碛	qimo
畦	qiqg
綦	qizi
歧	qisc
玘	qinv
亓	qimp
耆	qiqo
芑	qilv
屺	qivv
埼	qigz
憩	qiah
跂	qipc
芪	qilb
棨	qime
葺	qilq
蹊	qipm
颀	qitw
骐	qinh
汔	qika
圻	qigt
磜	qimf
萋	qilb
蜞	qich
蛴	qicq
亟	qirf
愭	qiho
桤	qiev
俟	qijo
荠	qilq
婍	qibz
郪	qift
稽	qixo
缉	qiiq
洓	qikm
鲯	qiwh
碶	qimm
䓫	qilz
𨙸	qict
𬨂	qiyb
掐	qwup
恰	qwhd
卡	qwyy
髂	qwfs
洽	qwkd
袷	qwtd
拤	qwuy
葜	qwlm
前	qmhp
钱	qmzp
千	qmlq
签	qmrf
浅	qmkp
欠	qmeq
铅	qmzd
牵	qmmq
遣	qmcu
潜	qmko
迁	qmlu
乾	qmna
谦	qmsc
嵌	qmve
钳	qmzz
黔	qmpa
茜	qmlv
钤	qmza
芡	qmle
歉	qmhe
虔	qmzv
芊	qmll
倩	qmjv
骞	qmwn
仟	qmjl
堑	qmyg
搴	qmwu
阡	qmtl
谴	qmsu
汧	qmkl
靬	qmte
荨	qmlk
愆	qmph
佥	qmjf
椠	qmye
扦	qmul
褰	qmwt
犍	qmqu
缱	qmiu
慊	qmhc
悭	qmhg
钎	qmzl
杄	qmel
鹐	qmxx
蒨	qmlv
岍	qmvl
磏	qmmc
纤	qmil
掮	qmuv
墘	qmga
肷	qmve
圲	qmgl
伣	qmje
𬘬	qmiv
强	qdbc
抢	qduz
枪	qdez
墙	qdgd
腔	qdvu
呛	qddz
羌	qdga
蔷	qdld
炝	qdcz
羟	qdgu
锵	qdzk
戗	qdjp
戕	qdap
锖	qdzv
樯	qded
玱	qdnz
镪	qdzc
蜣	qdca
嫱	qdbd
襁	qdtc
跄	qdpz
蔃	qdlc
敲	qcgh
桥	qcep
乔	qctp
翘	qcpz
瞧	qcqc
巧	qcua
撬	qcuv
壳	qcgo
鞘	qctv
俏	qcjv
樵	qcec
窍	qcea
谯	qcsc
锹	qczc
侨	qcjp
悄	qchv
跷	qcpp
荞	qclp
诮	qcsv
橇	qcev
峤	qcvp
劁	qcup
峭	qcvv
缲	qcie
硚	qcmp
鞒	qctp
雀	qcyu
憔	qchc
愀	qchc
硗	qcmp
且	qxfq
切	qxrp
妾	qxib
窃	qxep
怯	qxhk
茄	qxld
箧	qxrh
挈	qxau
伽	qxjd
锲	qxzm
惬	qxhh
郄	qxbt
慊	qxhc
趄	qxpf
琴	qnna
秦	qnax
亲	qnie
勤	qnls
寝	qnwr
擒	qnuv
钦	qnze
沁	qnkh
侵	qnjr
禽	qnjv
衾	qnjt
噙	qndv
芹	qnlt
骎	qnnr
溱	qnkx
覃	qnvn
嗪	qndx
芩	qnla
揿	qnue
梣	qnea
慬	qnha
嵚	qnve
螓	qncx
锓	qnzr
檎	qnev
吣	qndh
请	qysv
轻	qyyu
清	qykv
氢	qyvu
情	qyhv
青	qyav
晴	qyov
卿	qybi
倾	qyjw
庆	qyxm
黥	qypy
磬	qygm
顷	qyvw
擎	qylu
箐	qyrv
氰	qyvv
罄	qyga
蜻	qycv
鲭	qywv
綮	qymi
檠	qyle
亲	qyie
圊	qyrv
勍	qygs
碃	qymv
庼	qyxw
倩	qyjv
苘	qyld
穷	qses
琼	qsny
蛩	qsuc
邛	qsut
穹	qseb
茕	qsln
銎	qsuz
筇	qsrt
䓖	qsls
球	qqni
求	qqfi
秋	qqxc
邱	qqtt
丘	qqtf
裘	qqft
糗	qqpm
楸	qqec
囚	qqrj
逑	qqfu
湫	qqkc
虬	qqca
璆	qqne
酋	qqhy
仇	qqjk
萩	qqlc
遒	qqhu
鳅	qqwc
泅	qqkj
俅	qqji
鼽	qqok
赇	qqoi
龟	qqwg
蚯	qqcf
蝤	qqcy
鹙	qqxx
訄	qqks
犰	qqmk
巯	qqro
鞧	qqty
𨱇	qqzi
去	qugk
区	qunb
取	quqr
曲	quyq
娶	quqb
屈	qucm
趣	qupr
蛆	qucf
龋	qulv
驱	qunb
瞿	ququ
祛	qufk
渠	quke
趋	qupb
躯	quzb
鼩	qupg
觑	quze
诎	qusm
麹	quap
衢	qupu
蕖	qule
蘧	qulu
袪	qutk
胠	quvk
朐	quvg
劬	qugs
阒	quam
苣	quln
璩	qunj
癯	quau
鸲	qugx
戌	qunf
焌	quch
蠼	qucr
氍	quqv
黢	quph
岨	quvf
坥	qugf
灈	quku
岖	quvb
蛐	qucy
磲	qume
竘	quig
㭕	quek
䓛	qulm
𪨰	quvy
𫭟	qugb
全	qrjn
圈	qrrz
权	qrer
劝	qrrs
券	qrhp
拳	qrhu
犬	qrmq
泉	qruk
醛	qryn
蜷	qrcz
荃	qrln
颧	qrlw
诠	qrsn
佺	qrjn
铨	qrzn
鬈	qrpz
痊	qran
绻	qriz
筌	qrrn
畎	qrqm
悛	qrhh
辁	qryn
棬	qrez
瑔	qrnk
鳈	qrwk
婘	qrbz
𨟠	qrqt
却	qtgz
缺	qtaj
确	qtmt
卻	qthz
阙	qtae
雀	qtyu
瘸	qtaj
鹊	qtlx
榷	qteu
炔	qtcj
阕	qtam
悫	qtgh
碏	qtmo
埆	qtgt
𬒈	qtkm
群	qpbg
裙	qptd
囷	qprx
麇	qpxx
逡	qpku
然	rjvc
燃	rjcc
染	rjke
冉	rjmg
髯	rjpg
蚺	rjcg
苒	rjlg
䎃	rjmz
让	rhsf
穰	rhxf
嚷	rhdf
瓤	rhty
攘	rhuf
禳	rhff
壤	rhgf
瀼	rhkf
儴	rhjf
蘘	rhlf
绕	rkip
饶	rkqp
扰	rkuo
桡	rkep
娆	rkbp
荛	rklp
热	reuc
惹	relh
人	rfjr
任	rfjg
认	rfsj
忍	rfph
仁	rfjm
刃	rfpi
壬	rftg
韧	rfgi
饪	rfqg
稔	rfxh
妊	rfbg
衽	rftg
纫	rfii
仞	rfji
轫	rfyi
讱	rfsi
纴	rfig
葚	rfla
荏	rflg
仍	rgjv
扔	rguv
日	rior
驲	rino
融	rsnc
容	rswh
蓉	rslh
荣	rsle
溶	rskh
戎	rspn
绒	rsin
熔	rsch
冗	rswo
茸	rslq
榕	rseh
镕	rszh
嵘	rsve
狨	rsmn
瑢	rsnh
蝾	rsce
肉	rbmj
揉	rbue
柔	rbie
鞣	rbte
糅	rbpe
蹂	rbpe
𫐓	rbye
如	rubd
入	ruju
乳	ruya
汝	rukb
儒	rujl
辱	rufk
濡	rukl
茹	ruld
铷	ruzd
褥	rutk
襦	rutl
蓐	rulk
孺	ruhl
洳	rukd
蠕	rucl
溽	rukk
缛	ruik
嬬	rubl
嚅	rudl
薷	rull
颥	rutw
挼	rwub
软	rrye
阮	rrtp
堧	rrgm
瓀	rrnl
媆	rrbm
瑞	rvnl
睿	rvgq
锐	rvzp
蕊	rvlh
芮	rvlj
汭	rvkj
蚋	rvcj
蕤	rvll
枘	rvej
润	rpkn
闰	rpan
若	rold
弱	robw
箬	rord
偌	rojd
爇	rolc
蒻	rolw
鄀	rolt
婼	robd
撒	sauh
萨	salx
仨	sajt
洒	sakv
飒	saib
卅	sals
靸	satc
潵	sakh
挲	saku
脎	save
赛	slwo
塞	slwg
鳃	slwh
腮	slvh
噻	sldg
三	sjts
散	sjlh
伞	sjjn
叁	sjkt
糁	sjpe
毵	sjkv
馓	sjqh
桑	shre
嗓	shde
丧	shgt
颡	shrw
搡	shue
磉	shme
扫	skub
骚	sknc
嫂	skbr
搔	skuc
臊	skve
埽	skgr
缫	skie
瘙	skac
溞	skkc
色	sexm
瑟	sent
涩	seks
铯	sezm
塞	sewg
啬	segd
穑	sexd
璱	sent
森	sfee
僧	sgjo
啥	uada
杀	uabe
傻	uajh
沙	uakt
鲨	uakw
莎	ualt
煞	uaxc
纱	uait
砂	uamt
刹	uabp
痧	uaat
厦	uaxh
嗄	uadh
歃	uale
霎	uatb
铩	uaze
裟	uakt
唼	uadb
杉	uaee
挲	uaku
晒	ulov
筛	ulrr
色	ulxm
山	ujvs
删	ujip
闪	ujaj
善	ujgd
扇	ujmz
衫	ujte
擅	ujuf
陕	ujth
珊	ujni
膳	ujvd
杉	ujee
煽	ujcz
膻	ujvf
疝	ujav
骟	ujnz
钐	ujze
赡	ujos
讪	ujsv
禅	ujfn
剡	ujcp
缮	ujid
鳝	ujwd
苫	ujld
鄯	ujgt
芟	ujlr
嬗	ujbf
埏	ujgu
汕	ujkv
晱	ujoc
姗	ujbi
潸	ujkv
跚	ujpi
烻	ujcu
蟮	ujcd
单	ujhn
栅	ujei
舢	ujiv
墡	ujgd
嶦	ujvs
𫮃	ujgn
上	uhyf
商	uhid
伤	uhjs
熵	uhcd
尚	uhss
赏	uhso
殇	uhge
裳	uhst
觞	uhxe
墒	uhgd
垧	uhgd
晌	uhod
绱	uhis
少	ukyt
烧	ukcp
稍	ukxv
勺	ukni
捎	ukuv
哨	ukdv
邵	ukpt
绍	ukid
梢	ukev
苕	ukld
韶	ukxd
蛸	ukcv
劭	ukps
潲	ukkv
艄	ukiv
芍	ukli
筲	ukrv
召	ukpd
鞘	uktv
睄	ukqv
柖	uked
玿	uknd
社	uefg
蛇	uecv
设	uesr
射	uezk
舍	ueja
舌	ueas
摄	ueur
涉	ueks
折	ueut
赦	uegh
奢	uemo
赊	ueof
佘	uejf
麝	uexk
慑	uehr
歙	ueje
畲	uejq
阇	ueao
滠	uekr
厍	uexy
拾	ueud
猞	uema
𪨶	uevy
谁	uzsu
神	uffg
深	ufke
身	ufzs
申	ufog
肾	ufpv
沈	ufkp
甚	ufza
审	ufwg
伸	ufjg
什	ufjn
砷	ufmg
慎	ufhh
婶	ufbg
渗	ufke
侁	ufjp
糁	ufpe
哂	ufdv
蜃	uffc
莘	ufln
诜	ufsp
瘆	ufae
甡	ufll
参	ufke
燊	ufce
谌	ufsa
椹	ufea
矧	ufog
绅	ufig
呻	ufdg
屾	ufvv
珅	ufng
谂	ufsh
胂	ufvg
葚	ufla
鲹	ufwe
娠	ufbf
棽	ufea
瞫	ufqn
𬬹	ufzg
𬳽	ufnp
生	ugls
声	uggc
省	ugyq
升	ugtl
胜	ugvl
圣	ugrg
剩	ugxp
绳	ugid
笙	ugrl
昇	ugol
盛	ugna
晟	ugoa
牲	ugql
甥	ugls
陞	ugtg
眚	uglq
乘	ugxv
嵊	ugvv
是	uiot
时	uiok
式	uipu
使	uijb
事	uifb
师	uipr
史	uidb
诗	uisk
市	uizr
屎	uicp
十	uins
视	uife
室	uiwy
石	uims
试	uisu
实	uiwm
饰	uiqr
士	uigs
湿	uikc
食	uiqs
氏	uibs
势	uius
世	uila
施	uile
失	uith
始	uibd
尸	uics
识	uish
狮	uimr
适	uiau
矢	uios
嗜	uido
谥	uisa
誓	uius
拾	uiud
弑	uibu
释	uitu
示	uifs
恃	uihk
侍	uijk
仕	uijg
逝	uiuu
豕	uijs
轼	uiyu
蚀	uiqc
噬	uidj
匙	uiov
虱	uiac
拭	uiuu
祏	uifm
铈	uizr
柿	uier
奭	uimu
莳	uilk
驶	uinb
似	uijj
舐	uiab
筮	uirj
湜	uikt
栻	uieu
螫	uigc
贳	uilo
蓍	uilo
炻	uicm
什	uijn
酾	uiyv
鲥	uiwk
媞	uibt
鼫	uipm
鸤	uicx
嘘	uidc
鲺	uiwc
殖	uigf
峙	uivk
襫	uitu
邿	uigt
浉	uikr
埘	uigk
䏡	uivf
䴓	uifx
𫚕	uiwr
𬤊	uist
受	ubyr
手	ubus
收	ubih
首	ubho
瘦	ubar
守	ubwk
兽	ubhd
寿	ubak
售	ubud
授	ubur
熟	ubgc
绶	ubir
艏	ubio
狩	ubmk
书	uuai
数	uuph
树	uuek
属	uucv
输	uuyp
术	uuei
叔	uuyr
熟	uugc
蜀	uuyc
竖	uupi
鼠	uups
疏	uuto
舒	uuji
梳	uueo
赎	uuom
束	uuxs
孰	uugi
述	uueu
署	uuyo
黍	uuxk
塾	uugg
姝	uuba
恕	uubh
淑	uukr
庶	uuxc
戍	uuni
漱	uuke
殊	uuga
暑	uuoo
殳	uurs
薯	uulo
曙	uuoo
抒	uuui
蔬	uulo
枢	uueb
菽	uulr
澍	uukk
倏	uujm
墅	uudg
腧	uuvp
摅	uuuh
纾	uuii
隃	uutp
秫	uuxi
沭	uuki
婌	uubr
陎	uuta
毹	uujv
鄃	uujt
𬬸	uuzi
刷	uwcp
耍	uwlb
唰	uwdp
帅	uypr
甩	uyta
摔	uyun
衰	uytf
率	uyzn
蟀	uycn
涮	urkp
栓	uren
拴	urun
闩	uraf
腨	urvl
双	udrr
爽	udmb
霜	udtq
泷	udkt
孀	udbq
鹴	udtx
骦	udnq
漴	udkf
礵	udmq
水	uvks
谁	uvsu
睡	uvqg
税	uvxp
帨	uvrp
说	uvsp
顺	upow
舜	upyv
瞬	upqv
吮	updp
楯	upeq
说	uosp
硕	uomw
朔	uohv
槊	uohe
烁	uocy
搠	uouv
铄	uozy
数	uoph
妁	uobi
蒴	uolv
四	siys
死	sigv
斯	sizt
撕	siut
丝	siii
似	sijj
寺	sigk
思	siqh
私	sixk
司	siad
饲	siqd
嗣	sidd
巳	sivs
嘶	sidt
肆	sipb
祀	sifv
驷	siny
姒	sibj
俟	sijo
锶	sizh
泗	siky
厮	sixt
兕	simp
笥	sird
汜	sikv
咝	sidi
伺	sijd
鸶	siix
涘	siko
缌	siih
耜	siak
澌	sikt
蛳	sicr
虒	sixz
飔	sioh
凘	siwt
㟃	sivd
楒	sieh
送	sshu
宋	sswe
怂	ssjh
松	ssek
颂	sshw
诵	ssst
菘	sslk
崧	ssvk
耸	ssjq
嵩	ssvg
竦	ssix
淞	sskk
讼	sssk
娀	ssbn
凇	sswk
悚	sshx
𪨊	sscj
忪	sshk
㧐	ssur
搜	sbur
艘	sbir
嗖	sbdr
馊	sbqr
叟	sbpr
廋	sbxr
薮	sblh
溲	sbkr
瞍	sbqr
嗽	sbde
蒐	sbla
飕	sbor
嗾	sbdo
擞	sbuh
锼	sbzr
螋	sbcr
苏	sulh
酥	suyx
素	suai
速	suxu
俗	sujh
诉	susi
宿	suwu
粟	suvp
溯	sukv
塑	suhg
肃	subh
稣	suwx
谡	sush
愫	suhi
夙	suog
甦	sufl
涑	sukx
窣	suen
骕	sunh
蔌	sule
嗉	sudi
簌	sure
傃	suji
鹔	subx
蹜	supu
缩	suiu
僳	sujp
觫	suxx
𫗧	suqx
算	srrl
酸	sryh
蒜	srlf
狻	srmh
岁	svvl
随	svtu
虽	svdc
遂	svhu
碎	svmn
隋	svtv
穗	svxh
髓	svfu
燧	svcu
尿	svck
隧	svtu
睢	svqu
绥	svib
祟	svsf
荽	svlb
谇	svsn
眭	svqg
邃	sveu
濉	svku
旞	svlu
穟	svxu
璲	svnu
襚	svtu
𫟦	svyu
𬭼	svzu
孙	sphy
损	spuo
隼	spun
榫	spen
笋	sprt
飧	splq
荪	sply
狲	spmy
所	somt
锁	sozo
索	soni
缩	soiu
嗦	sodi
梭	soeh
娑	sokb
蓑	solf
唆	sodh
琐	sono
羧	sogh
睃	soqh
溹	soki
葰	solh
唢	sodo
嗍	sodv
莎	solt
挲	soku
桫	soet
他	taje
它	tawv
她	tabe
塔	tagd
塌	tagz
踏	tapo
祂	tafe
挞	tauu
拓	taum
铊	tazv
榻	taez
牠	taqe
趿	tapc
沓	tako
獭	tamo
闼	taau
蹋	tapz
鳎	tawz
溻	takz
遢	taou
鞳	tatd
阘	taaz
褟	tatz
鿎	tamu
太	tlmi
台	tlkd
态	tlmh
胎	tlvd
抬	tlud
泰	tlak
钛	tlzi
肽	tlvi
苔	tlld
汰	tlki
鲐	tlwd
骀	tlnd
邰	tlkt
薹	tlly
酞	tlyi
跆	tlpd
炱	tlkc
谈	tjsc
碳	tjmc
弹	tjbn
摊	tjuu
贪	tjjo
痰	tjac
探	tjue
谭	tjsn
叹	tjdr
滩	tjku
坛	tjgb
坦	tjgf
炭	tjvc
瘫	tjau
檀	tjef
毯	tjvc
潭	tjkn
昙	tjob
钽	tjzf
覃	tjvn
郯	tjct
坍	tjgz
璮	tjnf
镡	tjzn
惔	tjhc
忐	tjyh
菼	tjlc
袒	tjtf
倓	tjjc
澹	tjks
锬	tjzc
榃	tjeq
磹	tjmn
糖	thpd
汤	thke
唐	thxd
躺	thzs
烫	thkc
堂	thsg
趟	thps
棠	thse
淌	thks
塘	thgd
倘	thjs
膛	thvg
蹚	thpg
帑	thbr
樘	theg
镗	thzg
傥	thjp
溏	thkd
螳	thcg
镋	thzp
搪	thud
羰	thgc
嘡	thdg
螗	thcd
瑭	thnd
鄌	thxt
耥	thas
埫	thgs
铴	thze
䣘	thst
套	tkmp
淘	tkka
逃	tkpu
掏	tkua
讨	tksk
桃	tkew
陶	tkta
韬	tkgp
涛	tkkk
弢	tkbr
饕	tkdq
绦	tkie
洮	tkkw
叨	tkdp
滔	tkkp
萄	tkla
焘	tkac
梼	tkek
绹	tkia
啕	tkda
慆	tkhp
鼗	tkpc
𫘦	tkna
特	teqk
铽	tezh
慝	tenh
忒	teph
忑	tefh
忒	tzph
疼	tgaw
藤	tglk
腾	tgvn
滕	tgvk
熥	tgcu
誊	tghs
縢	tgvi
螣	tgvc
䲢	tgvw
题	tiow
提	tiut
体	tijf
踢	tipe
替	tiho
剃	tihp
梯	tiet
缇	tiit
锑	tizt
蹄	tipr
剔	tiop
啼	tidr
悌	tiht
涕	tikt
惕	tihe
薙	tilu
醍	tiyt
屉	tica
嚏	tidt
鹈	tihx
擿	tiuu
绨	tiit
荑	tilb
倜	tijd
裼	tite
媞	tibt
鳀	tiwt
逖	timu
趯	tipu
瑅	tint
遆	tiiu
䏲	tivt
䴘	tixx
𫘨	tint
天	tmfm
甜	tmaz
填	tmgh
田	tmqt
舔	tmah
添	tmkh
忝	tmfh
湉	tmka
殄	tmge
恬	tmha
腆	tmvh
阗	tmah
掭	tmuh
觍	tmie
瑱	tmnh
沺	tmkq
畋	tmqh
淟	tmkh
晪	tmoh
盷	tmqw
黇	tmnd
条	tche
跳	tcpw
挑	tcuw
调	tcsd
祧	tcfw
窕	tcew
朓	tcvw
粜	tcsp
蜩	tccd
佻	tcjw
眺	tcqw
苕	tcld
嬥	tcbu
鲦	tcwe
髫	tcpd
迢	tcpu
笤	tcrd
龆	tcld
贴	txod
铁	txzh
帖	txrd
餮	txgq
萜	txld
听	tydt
挺	tyuu
停	tyja
厅	tyxa
亭	tyga
艇	tyiu
庭	tyxu
汀	tyka
廷	tytu
婷	tyba
霆	tytu
烃	tycu
铤	tyzu
珽	tynu
梃	tyeu
渟	tyka
葶	tyla
蜓	tycu
莛	tylu
圢	tyga
桯	tyen
颋	tytw
侹	tyju
烶	tycu
䗴	tycu
𬘩	tyiu
同	tsmd
通	tsku
痛	tsat
铜	tszd
桶	tset
捅	tsut
筒	tsrd
佟	tsjw
统	tsip
童	tsid
酮	tsyd
瞳	tsqd
桐	tsed
彤	tsme
砼	tsmu
嗵	tsdu
僮	tsjd
恸	tshs
仝	tsju
穜	tsxd
潼	tskd
烔	tscd
橦	tsed
垌	tsgd
茼	tsld
洞	tskd
峒	tsvd
曈	tsod
哃	tsdd
鲖	tswd
㛚	tsbt
峂	tsvw
𦒍	tsiz
𫍣	tssd
头	tbwm
投	tbur
偷	tbjp
透	tbxu
骰	tbfr
图	turw
土	tugt
吐	tudg
涂	tukx
兔	tuwt
突	tuem
屠	tuco
徒	tuwp
凸	tuvf
秃	tuxo
途	tuju
荼	tulx
钍	tuzg
酴	tuyx
菟	tulw
凃	tuwx
稌	tuxx
堍	tugw
腯	tuvq
梌	tuex
葖	tulm
㻬	tuna
𬳿	tunx
团	trrt
彖	trbj
湍	trkl
抟	trui
猯	trml
疃	trqd
煓	trcl
推	tvuu
腿	tvvu
退	tviu
忒	tvph
颓	tvxw
褪	tvtu
蜕	tvcp
煺	tvcu
魋	tvau
𬯎	tvto
囤	tprs
臀	tpcv
吞	tpfd
屯	tpfs
豚	tpvj
鲀	tpws
暾	tpoh
焞	tpch
饨	tpqs
坉	tpgs
褪	tptu
忳	tphs
拖	toue
托	tour
脱	tovp
坨	togv
陀	totv
驼	tonv
驮	tonm
拓	toum
妥	toyb
佗	tojv
侂	tojr
唾	todg
沱	tokv
铊	tozv
橐	tone
鼍	todd
鸵	toxv
椭	toev
砣	tomv
柁	toev
箨	toru
跎	topv
酡	toyv
柝	toei
圫	togr
萚	tolu
庹	toxi
𬶍	towv
哇	wadg
挖	waua
娃	wabg
瓦	warw
蛙	wacg
袜	wate
洼	wakg
娲	wabj
凹	wamf
佤	wajr
窊	waey
坬	wagy
腽	wava
畖	waqy
外	wlly
歪	wlcs
崴	wlvb
万	wjfp
玩	wjnp
完	wjwp
晚	wjop
碗	wjmz
弯	wjzb
丸	wjki
湾	wjkb
挽	wjup
绾	wjik
腕	wjvz
纨	wjii
烷	wjcp
剜	wjwp
皖	wjup
菀	wjlz
卍	wjaa
宛	wjwz
顽	wjmw
豌	wjzz
婉	wjbz
莞	wjlp
畹	wjqz
脘	wjvp
椀	wjez
婠	wjbk
琬	wjnz
惋	wjhz
蜿	wjcz
芄	wjli
蔓	wjlr
塆	wjgb
𬇕	wjkp
往	whwn
王	whnw
网	whmb
望	whfn
忘	whfh
汪	whkn
亡	whfw
旺	whon
妄	whfb
枉	when
罔	whmf
辋	whyf
尢	whoy
惘	whhf
魍	whaf
尪	whon
为	wzii
位	wzji
未	wzaw
味	wzda
微	wzwh
喂	wzdt
伪	wzji
胃	wzqv
维	wziu
威	wznb
唯	wzdu
魏	wzxa
尾	wzcv
卫	wzzf
谓	wzsv
围	wzrg
韦	wzgw
惟	wzhu
委	wzxb
危	wzxz
薇	wzlh
畏	wzqt
煨	wzct
伟	wzjg
隈	wztt
炜	wzcg
违	wzgu
尉	wzck
苇	wzlg
萎	wzlb
慰	wzch
纬	wzig
鲔	wzwv
蔚	wzlk
圩	wzgn
艉	wziv
玮	wzng
帷	wzru
渭	wzkv
帏	wzrg
洧	wzkv
桅	wzez
猥	wzmt
痿	wzab
巍	wzva
嵬	wzva
猬	wzmv
薳	wzlu
鳚	wzwk
潍	wzku
亹	wzzf
葳	wzlb
偎	wzjt
闱	wzag
诿	wzsb
韪	wzog
娓	wzbv
隗	wzta
溦	wzkh
沩	wzki
硙	wzmv
崴	wzvb
煟	wzcv
廆	wzxa
逶	wzxu
碨	wzmt
涠	wzkg
洈	wzkz
霨	wztk
琟	wznu
峗	wzvz
螱	wzcc
鳂	wzwt
𣲗	wzkg
𫇭	wzli
𬀩	wzog
𬱟	wzxw
𬶏	wzwz
问	wfad
文	wfvw
稳	wfxh
闻	wfaq
纹	wfiv
温	wfka
吻	wfde
蚊	wfcv
瘟	wfaa
玟	wfnv
雯	wftv
汶	wfkv
炆	wfcv
辒	wfya
刎	wfnp
阌	wfar
紊	wfvi
蕰	wfla
榅	wfea
芠	wflv
鳁	wfwa
璺	wfpi
𫘜	wfnv
翁	wghz
嗡	wgdz
瓮	wghr
滃	wgkz
蓊	wglz
蕹	wglu
鹟	wghx
𬭩	wgzz
我	wotp
喔	wody
窝	woej
握	wouy
沃	wokm
卧	woqy
涡	wokj
倭	wojb
斡	wonj
龌	woly
渥	woky
偓	wojy
蜗	wocj
挝	wouu
肟	wova
幄	wory
硪	womp
涴	wokz
莴	wolj
踒	wopb
无	wudu
五	wuwu
物	wuqe
吴	wudm
吾	wuwd
勿	wune
乌	wuxu
舞	wuev
武	wufs
屋	wucy
误	wusm
悟	wuhd
唔	wudd
雾	wuts
捂	wuud
伍	wujw
戊	wunu
污	wuka
呜	wudx
午	wuen
务	wuhs
巫	wuuj
兀	wufp
钨	wuzx
坞	wugx
恶	wufh
毋	wuku
邬	wuxt
诬	wusj
寤	wuwd
庑	wuxd
侮	wujk
焐	wucd
芜	wuld
旿	wuon
忤	wuhn
鹜	wuix
梧	wued
晤	wuod
骛	wuin
杌	wuep
迕	wueu
鹀	wuux
鼯	wupd
圬	wuga
妩	wubd
怃	wuhd
洿	wuka
浯	wukd
珷	wuns
芴	wule
婺	wuib
鋈	wukz
屼	wuvp
鹉	wufx
铻	wuzd
珸	wund
蜈	wucm
牾	wuqd
郚	wuwt
仵	wujn
痦	wuad
靰	wutp
峿	wuvd
𣲘	wukd
系	xiti
洗	xikp
戏	xirp
西	xivx
细	xiiq
吸	xidc
喜	xihd
兮	xiha
希	xibr
席	xixr
膝	xivk
稀	xixr
锡	xize
习	xizx
奚	xiym
息	xioh
昔	xilo
硒	ximv
惜	xiho
袭	xitt
溪	xikm
悉	xith
徙	xiws
曦	xiop
析	xiet
玺	xixi
熄	xich
隙	xity
夕	xilx
汐	xikl
蜥	xict
熙	xiqc
茜	xilv
嘻	xidd
檄	xieh
铣	xizp
晞	xior
晰	xiot
犀	xicq
禧	xifd
嬉	xibd
豨	xijr
烯	xicr
釐	xiad
隰	xitc
羲	xigp
郤	xiht
谿	xiyh
郗	xibt
牺	xiqv
歙	xije
僖	xijd
熹	xihc
咥	xidy
禊	xifm
翕	xijz
觋	xiue
皙	xieu
媳	xibh
枲	xike
嶲	xivm
饩	xiqv
醯	xiya
憙	xihh
唏	xidr
舄	xipc
浠	xikr
舾	xiiv
淅	xikt
蹊	xipm
傒	xijm
螅	xich
肸	xivn
屣	xics
觿	xixd
酅	xivt
穸	xiel
屃	xico
蓰	xils
潟	xikc
鳛	xiwu
裼	xite
鼷	xipm
阋	xiap
绤	xiih
蟋	xich
葸	xilh
樨	xieq
爔	xicp
睎	xiqr
熻	xicz
粞	xipv
巇	xivp
窸	xieh
俙	xijr
菥	xilt
恓	xihv
嶍	xivu
暿	xiod
饻	xiqt
𠅤	xizh
𫘬	xinm
𬭳	xizd
𬶮	xiwd
下	xwfy
瞎	xwqd
夏	xwfh
侠	xwjh
虾	xwcy
吓	xwdy
霞	xwtr
峡	xwvh
瑕	xwnr
狭	xwmh
匣	xwns
辖	xwyd
呷	xwds
叚	xwcr
暇	xwor
狎	xwms
遐	xwcu
硖	xwmh
罅	xwan
柙	xwes
黠	xwpd
厦	xwxh
翈	xwsz
先	xmqp
线	xmip
险	xmtf
弦	xmbi
现	xmne
县	xmfk
嫌	xmbc
仙	xmjv
咸	xmnd
显	xmoc
鲜	xmwg
限	xmti
闲	xmae
藓	xmlg
馅	xmqp
献	xmnm
贤	xmpo
掀	xmue
陷	xmtp
衔	xmpz
见	xmej
酰	xmyp
氙	xmvv
腺	xmvk
娴	xmbe
羡	xmge
霰	xmth
筅	xmrp
纤	xmil
宪	xmwp
籼	xmpv
蚬	xmce
冼	xmwp
舷	xmii
涎	xmku
岘	xmve
苋	xmle
狝	xmmy
跣	xmpp
燹	xmjc
锨	xmze
洗	xmkp
祆	xmfm
暹	xmou
缐	xmik
猃	xmmf
痫	xmae
伭	xmji
崄	xmvf
跹	xmpu
莶	xmlf
挦	xmuk
孅	xmbf
忺	xmhe
鹇	xmax
禒	xmfj
㬎	xmoc
𪾢	xmqe
𫍯	xmsd
𬀪	xmoe
𬸣	xmwx
想	xdeh
像	xdjw
向	xdtd
项	xduw
香	xdxo
相	xdeq
象	xdwx
箱	xdrq
乡	xdix
响	xddd
降	xdtv
翔	xdgz
橡	xdew
巷	xdlv
享	xdgh
湘	xdkq
厢	xdxq
镶	xdzf
祥	xdfg
饷	xdqd
飨	xdiq
详	xdsg
襄	xdtf
芗	xdli
庠	xdxg
骧	xdnf
缃	xdiq
瓖	xdnf
鲞	xdhw
珦	xdnd
葙	xdlq
𬙋	xdif
小	xcyx
笑	xcrm
肖	xcyv
校	xceb
箫	xcrh
孝	xcqh
逍	xcyu
萧	xclh
消	xckv
削	xcyp
晓	xcop
效	xcah
销	xczv
枭	xcxe
筱	xcrh
鸮	xcdx
骁	xcnp
咲	xcdm
宵	xcwv
魈	xcav
硝	xcmv
崤	xcvv
枵	xcea
啸	xcdh
绡	xciv
霄	xctv
潇	xckh
蛸	xccv
嚣	xcdd
虓	xckz
翛	xcjz
猇	xcmz
淆	xckv
皛	xcuu
哮	xcdh
洨	xckb
哓	xcdp
涍	xckh
滧	xckh
蟏	xcch
敩	xckh
𫍲	xcsr
写	xxwf
些	xxsm
鞋	xxtg
血	xxta
谢	xxsk
斜	xxjj
蟹	xxxc
邪	xxlt
携	xxuv
卸	xxaz
歇	xxoe
屑	xxcv
挟	xxuh
协	xxnh
泻	xxkf
泄	xxka
蝎	xxcf
械	xxel
偕	xxju
燮	xxsr
谐	xxsu
胁	xxvh
解	xxxq
榭	xxek
楔	xxem
薤	xxlf
澥	xxkq
亵	xxti
缬	xxiw
懈	xxhq
绁	xxia
撷	xxuw
絜	xxai
廨	xxxq
獬	xxmq
渫	xxke
勰	xxsh
偰	xxjm
瀣	xxkf
颉	xxgw
邂	xxxu
揳	xxum
叶	xxdn
薢	xxlq
躞	xxpr
榍	xxev
㙦	xxjg
𤫉	xxnr
𬹼	xxlp
新	xnit
心	xnhx
信	xnjs
芯	xnlh
锌	xnzn
辛	xnnx
薪	xnlt
欣	xnte
鑫	xnzz
馨	xngo
昕	xnot
忻	xnht
歆	xnxe
衅	xntu
炘	xnct
镡	xnzn
囟	xntb
伈	xnjh
莘	xnln
䜣	xnst
𫷷	xnxe
型	xyfg
性	xyhl
星	xyol
行	xypx
形	xyfe
姓	xybl
醒	xyyl
兴	xykh
邢	xyft
刑	xyfp
幸	xygg
杏	xyed
腥	xyvl
陉	xytu
擤	xyul
荇	xylp
省	xyyq
饧	xyqe
猩	xyml
煋	xycl
骍	xynn
婞	xybg
惺	xyhl
荥	xylk
铏	xyzp
悻	xyhg
钘	xyzl
瑆	xynl
硎	xymp
𫰛	xybu
胸	xsvm
熊	xskc
凶	xsbm
兄	xsdp
雄	xsnu
匈	xsnm
芎	xslb
夐	xsxh
讻	xssm
汹	xskm
诇	xssd
修	xqje
秀	xqxv
休	xqje
绣	xqiv
嗅	xqdm
溴	xqkm
锈	xqzv
羞	xqgg
袖	xqtd
咻	xqde
脩	xqjv
岫	xqvd
朽	xqea
髹	xqpe
宿	xqwu
琇	xqnv
貅	xqme
庥	xqxe
滫	xqkv
臭	xqom
珛	xqnv
馐	xqqg
鸺	xqjx
䗛	xqcv
需	xutl
虚	xuzc
徐	xuwx
须	xuew
许	xusn
续	xuim
序	xuxi
嘘	xudc
叙	xujr
恤	xuha
蓄	xulq
旭	xuko
戌	xunf
绪	xuio
絮	xubi
墟	xugc
胥	xutv
圩	xugn
栩	xuez
诩	xusz
吁	xudn
婿	xubv
昫	xuog
煦	xuoc
媭	xueb
勖	xuos
蓿	xulu
盱	xuqn
酗	xuym
顼	xunw
糈	xupv
溆	xukr
欻	xuce
洫	xuka
湑	xukv
畜	xuzq
醑	xuyv
浒	xukn
旴	xuon
垿	xugi
魆	xuan
谞	xusv
珝	xunz
㳚	xuki
冔	xuon
𦈡	xuil
𬣙	xusn
选	xrqu
癣	xrag
悬	xrfh
炫	xrci
玄	xrzi
宣	xrwf
旋	xrlt
轩	xrye
萱	xrlf
璇	xrnt
泫	xrki
渲	xrkf
喧	xrdf
玹	xrni
烜	xrcf
铉	xrzi
漩	xrkt
暄	xrof
瑄	xrnf
谖	xrsr
绚	xrio
楦	xref
券	xrhp
煊	xrcf
衒	xrpi
眩	xrqi
咺	xrdf
儇	xrjt
禤	xrfz
晅	xrof
翾	xryz
碹	xrmf
昡	xroi
琄	xrnv
痃	xrai
暶	xrot
愃	xrhf
𫍽	xrst
𫓶	xrzv
𫠊	xrni
学	xtkh
血	xtta
雪	xttb
薛	xtln
靴	xttv
穴	xtex
削	xtyp
谑	xtsb
噱	xtdj
鳕	xtwb
踅	xtup
茓	xtle
峃	xtkv
寻	xpbk
熏	xplp
训	xpso
逊	xphu
巡	xpou
勋	xpds
埙	xpgo
巽	xpvh
讯	xpsn
循	xpwq
荀	xplo
旬	xpno
殉	xpgo
薰	xplp
询	xpso
迅	xpau
洵	xpko
徇	xpwo
驯	xpno
蕈	xpln
浔	xpkk
郇	xpnt
鲟	xpwk
荨	xplk
恂	xpho
醺	xpyp
栒	xpeo
曛	xpop
獯	xpmp
汛	xpkn
珣	xpno
噀	xpdh
峋	xpvo
浚	xpkh
𫄸	xpip
𬊈	xpck
𬍤	xpnk
𬘓	xpio
𬩽	xpbt
呀	yadl
压	yaxi
牙	yaly
鸭	yasx
亚	yafc
雅	yalu
押	yaus
丫	yahg
芽	yall
吖	yadg
娅	yabc
哑	yadc
崖	yavg
涯	yakg
氩	yavc
鸦	yalx
伢	yajl
衙	yapd
轧	yaya
蚜	yacl
垭	yagc
猰	yamm
玡	yanl
琊	yant
砑	yaml
桠	yaec
迓	yalu
讶	yasl
揠	yaub
睚	yaqg
岈	yavl
堐	yagg
盐	yjga
眼	yjqi
演	yjkh
烟	yjcm
言	yjsy
沿	yjkd
研	yjml
焉	yjfc
严	yjfx
颜	yjiw
腌	yjva
岩	yjvm
宴	yjwb
燕	yjlc
验	yjnf
炎	yjcc
咽	yjdm
延	yjtu
彦	yjie
阎	yjap
厌	yjxm
艳	yjam
掩	yjua
闫	yjat
焰	yjcp
淹	yjka
晏	yjob
俨	yjjx
雁	yjxu
鄢	yjft
妍	yjbl
嫣	yjbc
阏	yjaw
檐	yjes
偃	yjjb
焱	yjcc
衍	yjpk
阉	yjaa
砚	yjme
魇	yjxa
甗	yjzr
兖	yjap
谳	yjsm
筵	yjru
罨	yjya
赝	yjxo
弇	yjjl
湮	yjkg
酽	yjyx
奄	yjma
琰	yjnc
堰	yjgb
餍	yjxq
郾	yjnt
滟	yjkm
沇	yjkp
芫	yjlp
铅	yjzd
谚	yjse
黡	yjxp
嬿	yjbc
唁	yjds
胭	yjvm
蜒	yjcu
渰	yjkl
墕	yjgc
棪	yjec
戭	yjwp
掞	yjuc
蝘	yjcb
殷	yjzr
鼹	yjpb
崦	yjva
厣	yjxs
恹	yjhm
漹	yjkc
虤	yjzz
扊	yjmc
䶮	yjtm
觃	yjeh
𪩘	yjvm
𫄧	yjiu
𬙂	yjih
𬸘	yjnx
杨	yhee
养	yhgp
羊	yhgy
样	yheg
氧	yhvg
阳	yhto
痒	yhag
洋	yhkg
扬	yhue
央	yhmm
仰	yhjz
漾	yhkk
鞅	yhtm
旸	yhoe
秧	yhxm
佯	yhjg
烊	yhcg
殃	yhgm
飏	yhoe
炀	yhce
钖	yhze
羕	yhgk
疡	yhae
鸯	yhmx
恙	yhgh
垟	yhgg
蛘	yhcg
泱	yhkm
怏	yhhm
玚	yhne
徉	yhwg
咉	yhdm
要	ykvb
药	ykli
腰	ykvb
妖	ykbm
咬	ykdb
邀	ykuu
摇	ykua
尧	ykpp
姚	ykbw
舀	ykyp
约	ykii
幺	ykiy
曜	ykou
瑶	ykna
谣	yksa
窑	ykea
遥	ykyu
垚	ykgg
爻	ykbb
夭	yktm
耀	ykmu
吆	ykdi
杳	ykeo
窈	ykes
峣	ykvp
肴	ykbv
徭	ykwa
钥	ykzv
鳐	ykwa
窅	ykeq
鹞	ykyx
铫	ykzw
珧	yknw
轺	ykyd
疟	ykab
靿	ykts
侥	ykjp
崾	ykvb
猺	ykma
媱	ykba
㙘	ykgb
也	yeey
页	yewy
叶	yedn
野	yedi
夜	yezv
业	yecy
耶	yeqt
液	yekv
爷	yehz
噎	yedz
邺	yect
掖	yeuv
谒	yesf
椰	yeet
曳	yeot
冶	yewd
晔	yeon
烨	yecn
铘	yezt
腋	yevv
靥	yexb
倻	yejt
咽	yedm
馌	yeqa
揶	yeut
以	yivj
一	yifi
亿	yija
已	yivi
亦	yizc
易	yioe
矣	yiko
乙	yiai
译	yisu
意	yixh
仪	yijb
依	yijt
咦	yidb
伊	yijt
椅	yiez
衣	yiti
医	yino
义	yiib
翼	yizh
宜	yiwf
异	yivl
裔	yitd
益	yika
邑	yidm
移	yixl
壹	yigz
役	yiwr
奕	yizm
夷	yimb
艺	yila
疑	yivt
倚	yijz
逸	yiwu
姨	yibb
忆	yiha
遗	yicu
议	yisb
蚁	yicb
噫	yidh
抑	yiuz
怡	yihd
乂	yibi
铱	yizt
溢	yika
驿	yinu
疫	yiar
翊	yiiz
埸	yige
胰	yivb
刈	yibp
颐	yiqw
毅	yiir
钇	yiza
懿	yigh
诣	yiso
彝	yibl
揖	yiuq
弋	yipi
翳	yinz
轶	yiyh
羿	yizl
祎	yifg
猗	yimz
尾	yicv
镒	yiza
贻	yiod
佚	yijh
燚	yicc
谊	yisf
弈	yizl
诒	yisd
咿	yidt
扆	yimt
镱	yizh
佾	yijv
浥	yikm
臆	yivh
瘗	yiag
缢	yiia
沂	yikt
殪	yigz
峄	yivu
圯	yigv
绎	yiiu
熠	yicu
迤	yieu
劓	yiop
翌	yizi
漪	yikz
苡	yilj
饴	yiqd
嶷	yivt
匜	yine
屹	yiva
肄	yivb
挹	yium
裛	yitm
潩	yikh
舣	yiib
怿	yihu
踦	yipz
螠	yica
嗌	yida
簃	yirl
薏	yilh
黟	yipl
洢	yikt
繄	yini
荑	yilb
旖	yilz
佁	yijd
悒	yihm
嫕	yibh
鹢	yikx
勚	yils
呓	yida
眙	yiqd
蜴	yice
酏	yiye
鹝	yinx
艾	yilb
廙	yixh
枍	yiea
癔	yiah
痍	yiab
杙	yiep
宧	yiwq
椸	yiee
扅	yiml
㑊	yijc
𫄷	yiih
𫖮	yivw
𬟁	yilx
𬬩	yizp
𬺈	yilz
因	ynrm
音	ynxy
银	ynzi
印	ynbz
引	ynbg
阴	yntv
饮	ynqe
隐	ynth
瘾	ynah
殷	ynzr
尹	ynbt
吟	ynda
寅	ynwh
荫	ynlv
淫	ynkg
胤	ynpv
龈	ynli
铟	ynzm
洇	ynkm
蚓	yncg
茵	ynlm
鄞	ynlt
堙	yngg
愔	ynhx
骃	ynnm
喑	yndx
垠	yngi
窨	ynex
氤	ynvm
禋	ynfg
嚚	yndd
霪	yntg
姻	ynbm
訚	ynas
龂	ynlt
崟	ynvz
慭	ynah
夤	ynlh
溵	ynkr
茚	ynlz
狺	ynms
蟫	yncn
吲	yndg
硍	ynmi
珢	ynni
歅	ynve
䲟	ynwz
𬘡	ynim
𬤇	ynsg
𬮱	ynag
应	yyxf
硬	yymb
赢	yyfi
英	yylm
营	yyld
樱	yyeb
影	yyoe
鹰	yyxx
迎	yybu
盈	yyva
嬴	yyfi
郢	yydt
嘤	yydb
瑛	yynm
蝇	yycd
颖	yyvw
映	yyom
莺	yylx
萤	yylc
婴	yyob
瀛	yyki
莹	yyli
颍	yyvw
媵	yyvb
鹦	yyox
膺	yyxv
瘿	yyab
缨	yyib
楹	yyea
荧	yylc
萦	yyli
罂	yyoa
撄	yyub
锳	yyzm
滢	yyki
荥	yylk
溁	yyke
潆	yyki
蓥	yylz
璎	yynb
茔	yylg
媖	yybm
䓨	yyla
哟	yodi
唷	yodv
育	yobv
用	ysty
勇	ysks
永	ysik
咏	ysdk
拥	ysut
涌	yskt
庸	ysxt
蛹	ysct
雍	yszu
颙	ysqw
俑	ysjt
佣	ysjt
慵	ysht
泳	yskk
踊	yspt
壅	yszg
痈	ysat
甬	yskt
鳙	yswt
饔	yszq
邕	ysom
镛	yszt
鄘	ysxt
澭	ysku
臃	ysvu
墉	ysgt
喁	ysdv
恿	yskh
埇	ysgt
栐	ysek
㶲	ysct
鲬	yswt
有	ybnv
又	ybry
由	ybdy
油	ybkd
右	ybnd
游	ybkh
哟	ybdi
呦	ybds
优	ybjo
友	ybnr
尤	yboy
铀	ybzd
鼬	ybpd
犹	ybmo
佑	ybjd
祐	ybfd
忧	ybho
幽	ybvi
釉	ybtd
幼	ybis
邮	ybdt
酉	ybyy
疣	ybao
诱	ybsv
悠	ybjh
柚	ybed
宥	ybwv
鱿	ybwo
攸	ybjh
繇	ybyi
囿	ybrv
卣	ybyn
侑	ybjv
铕	ybzv
猷	ybhm
牖	yban
莠	yblv
蚴	ybcs
麀	ybxv
羑	ybgi
鲉	ybwd
莜	yblh
黝	ybps
莸	yblo
耰	ybah
槱	ybec
蝤	ybcy
浟	ybkh
蝣	ybch
蚰	ybcd
𬨎	ybyy
与	yuff
于	yufn
鱼	yuwv
宇	yuwn
於	yulw
欲	yuhe
语	yusd
雨	yutv
余	yujx
预	yuiw
玉	yuni
羽	yuzv
域	yugf
瑜	yunp
遇	yuqu
御	yuwz
禹	yutv
逾	yuju
愈	yujh
俞	yujp
虞	yuzm
渔	yukw
予	yuiv
豫	yuiw
愚	yuqh
驭	yunr
喻	yudp
渝	yukp
裕	yuth
育	yubv
郁	yunt
狱	yumm
瘀	yuaw
浴	yukh
舆	yuph
彧	yupe
娱	yubm
鹬	yuix
芋	yuln
峪	yuvh
誉	yuks
隅	yutv
昱	yuoi
欤	yufe
谕	yusp
榆	yuep
寓	yuwv
淤	yukw
鬻	yubn
煜	yuci
毓	yueo
阈	yuaf
圉	yurg
聿	yubv
吁	yudn
瑀	yunv
鄅	yutt
庾	yuxj
愉	yuhp
盂	yufa
钰	yuzi
迂	yufu
屿	yuvf
禺	yuqv
竽	yurn
遹	yuiu
淯	yukv
妤	yubi
窳	yuey
纡	yuin
妪	yubb
鹆	yuhx
俣	yujm
喁	yudv
棫	yuef
燠	yucm
雩	yuta
腴	yuvj
舁	yupl
玙	yunf
谀	yusj
矞	yuid
敔	yuwh
饫	yuqm
畬	yujq
熨	yucc
潏	yukd
堉	yugv
嵛	yuvp
蜮	yucf
圄	yurd
艅	yuix
揄	yuup
萸	yulj
邘	yuft
臾	yupj
褕	yutp
燏	yucd
窬	yuep
髃	yufv
瘐	yuaj
觎	yuje
龉	yuld
嵎	yuvv
尉	yuck
蔚	yulk
狳	yumx
滪	yukw
伛	yujb
蝓	yucp
蓣	yulw
悆	yujh
㺄	yump
元	yrmp
原	yrxy
远	yrmu
源	yrky
愿	yrxh
圆	yrro
院	yrtp
员	yrdo
园	yrrp
袁	yrgt
猿	yrmt
缘	yrij
怨	yrlh
冤	yrww
苑	yrlz
渊	yrkp
援	yrur
爰	yryr
垣	yrgf
鸢	yrpx
螈	yrcy
鼋	yrmd
沅	yrkp
妧	yrbp
媛	yrbr
掾	yruj
塬	yrgy
瑗	yrnr
鸳	yrlx
嫄	yrby
辕	yryt
芫	yrlp
涴	yrkz
垸	yrgp
橼	yrej
蜎	yrcv
眢	yrlq
圜	yrrt
湲	yrkr
箢	yrrz
羱	yrgy
𫘪	yrny
月	ytvy
越	ytpn
约	ytii
曰	ytor
粤	ytta
岳	yttv
乐	ytby
悦	ythp
阅	ytap
跃	ytpm
钺	ytzn
玥	ytnv
樾	yten
刖	ytvp
籥	ytrd
龠	ytjd
瀹	ytkd
哕	ytdl
栎	ytey
爚	ytcd
钥	ytzv
彟	ytbr
𫐄	ytyp
𬸚	ytmx
云	ypby
运	ypbu
晕	ypoy
韵	ypxw
孕	ypvh
匀	ypnw
允	ypkp
熨	ypcc
芸	yplb
陨	ypto
愠	ypha
筠	yprw
蕴	ypla
殒	ypgo
昀	ypow
妘	ypbb
赟	ypvo
狁	ypmp
韫	ypga
恽	yphy
氲	ypva
缊	ypia
郓	ypwt
耘	ypab
郧	ypdt
酝	ypyb
筼	ypro
煴	ypca
沄	ypkb
纭	ypib
鋆	ypgz
涢	ypko
员	ypdo
馧	ypxa
𫖳	ypbw
咋	zadw
砸	zamr
杂	zake
咂	zadr
匝	zanr
扎	zaua
拶	zaul
臜	zavo
在	zlng
再	zlfg
载	zlny
哉	zlnd
崽	zlvh
宰	zlwn
仔	zljh
栽	zlne
灾	zlwc
甾	zloq
赞	zjqo
咱	zjdo
攒	zjuo
暂	zjyo
簪	zjro
錾	zjyz
瓒	zjno
拶	zjul
昝	zjho
酂	zjqt
趱	zjpo
糌	zjpo
寁	zjws
脏	zhvg
葬	zhll
臧	zhnq
藏	zhlq
牂	zhag
赃	zhog
奘	zham
驵	zhnf
早	zkon
造	zkqu
遭	zkfu
灶	zkcg
糟	zkpo
枣	zkew
凿	zkcm
澡	zkke
皂	zkur
燥	zkce
躁	zkpe
藻	zkle
噪	zkde
蚤	zkrc
璪	zkne
慥	zkhu
簉	zkru
唣	zkdr
𥖨	zkme
则	zeop
啧	zedo
泽	zeku
择	zeuu
责	zeao
仄	zexj
帻	zero
昃	zeoj
咋	zedw
迮	zewu
笮	zerw
箦	zero
赜	zeqo
舴	zeiw
贼	zzon
鲗	zzwp
怎	zfwh
谮	zfso
增	zggo
赠	zgoo
甑	zghr
缯	zgio
曾	zgho
憎	zgho
鄫	zght
罾	zgyo
矰	zgoo
锃	zgzn
综	zgif
䎖	zghz
炸	vacw
渣	vakf
扎	vaua
榨	vaew
乍	vawa
札	vaea
闸	vaas
诈	vasw
眨	vaqr
吒	vadr
栅	vaei
咤	vadr
铡	vazp
轧	vaya
揸	vauf
鲊	vaww
砟	vamw
楂	vaef
劄	varp
喳	vadf
霅	vats
拃	vauw
咋	vadw
溠	vaku
哳	vadt
奓	vaml
蚱	vacw
查	vaef
馇	vaqf
挓	vaur
柞	vaew
喋	vade
痄	vaaw
䃎	vaml
鲝	vagw
齇	vaof
债	vljo
窄	vlew
宅	vlwr
摘	vluc
寨	vlwe
斋	vlvl
翟	vlzu
祭	vlhf
择	vluu
瘵	vlaf
豸	vlmi
站	vjid
占	vjyd
战	vjyp
斩	vjyt
粘	vjpd
沾	vjkd
展	vjct
詹	vjxs
蘸	vjlc
栈	vjep
盏	vjfa
毡	vjvd
瞻	vjqs
旃	vjlz
绽	vjit
湛	vjka
辗	vjyt
鳣	vjwf
鹯	vjzx
飐	vjod
崭	vjvt
栴	vjez
谵	vjss
偡	vjja
搌	vjut
𫗴	vjqf
张	vhbp
章	vhxn
涨	vhkp
长	vhpc
帐	vhrp
账	vhop
仗	vhjb
掌	vhsu
杖	vheb
胀	vhvp
丈	vhfb
彰	vhxe
障	vhtn
璋	vhnn
蟑	vhcn
鄣	vhxt
瘴	vhan
漳	vhkn
嶂	vhvn
獐	vhmn
樟	vhen
幛	vhrn
仉	vhjo
嫜	vhbn
暲	vhon
找	vkup
招	vkud
赵	vkpb
照	vkoc
兆	vkpw
罩	vkyn
诏	vksd
昭	vkod
召	vkpd
朝	vknv
着	vkgq
棹	vken
肇	vkmb
钊	vkzp
沼	vkkd
曌	vkou
爪	vkya
旐	vklw
笊	vkry
啁	vkdd
𬬿	vkzd
𬶐	vkww
这	vevu
者	veqo
着	vegq
折	veut
浙	vekt
遮	vexu
哲	veud
辄	veya
锗	vezo
褶	vetu
蛰	veuc
辙	veyh
啫	vedo
柘	veem
谪	vesc
蜇	veuc
喆	vegd
磔	veme
赭	vego
蔗	velc
晢	veuo
詟	vets
鹧	vexx
䗪	vexc
真	vfnh
朕	vfvm
镇	vfzh
帧	vfro
针	vfzn
阵	vfty
枕	vfep
震	vftf
臻	vfyx
珍	vfne
甄	vfvr
振	vfuf
贞	vfyo
箴	vfrd
诊	vfse
缜	vfih
斟	vfzj
侦	vfjo
鸩	vfwx
砧	vfmd
赈	vfof
祯	vffo
轸	vfye
榛	vfex
疹	vfae
桢	vfeo
胗	vfve
圳	vfgo
畛	vfqe
稹	vfxh
禛	vffh
鬒	vfph
瑧	vfnx
葴	vfld
蓁	vflx
揕	vfua
袗	vfte
浈	vfko
昣	vfoe
纼	vfig
正	vgfs
证	vgss
挣	vgub
蒸	vglc
整	vgxs
症	vgas
争	vgxb
郑	vght
征	vgws
政	vgfh
睁	vgqb
筝	vgrb
怔	vghs
烝	vgac
钲	vgzs
铮	vgzb
狰	vgmb
拯	vguf
峥	vgvb
诤	vgsb
只	vidh
之	viri
至	viyi
值	vijf
指	viuo
纸	viib
制	viqp
治	vikd
直	vinf
知	viod
支	vici
致	viyh
质	vixo
汁	vikn
志	vigh
置	viyf
智	vioo
止	visi
酯	viyo
职	viqh
执	viui
掷	viut
枝	viec
痣	viah
脂	vivo
趾	vips
彘	vibv
织	viih
吱	vidc
芝	vilr
植	vief
滞	vikr
跖	vipm
炙	vivc
秩	vixh
旨	vivo
侄	vijy
徵	viwh
祗	vifi
栀	viez
芷	vils
址	vigs
雉	viou
窒	viey
肢	vivc
陟	vits
痔	viak
沚	viks
枳	vieh
栉	viez
稚	vixu
卮	vixz
挚	viuu
郅	viyt
轵	viyh
殖	vigf
畤	viqk
峙	vivk
絷	viui
帙	virh
摭	viuc
蛭	vicy
鸷	viux
铚	vizy
蜘	vicd
踬	vipo
祉	vifs
埴	vigf
帜	virh
豸	vimi
扺	viub
贽	viuo
锧	vizo
骘	vitn
踯	vipt
咫	vich
觯	vixn
桎	viey
滍	vikc
泜	viki
黹	vicf
轾	viyy
跱	vipk
忮	vihc
氏	vibs
稙	vixf
疐	vint
识	vish
禔	vift
胝	vivi
晊	vioy
庤	vixk
梽	vieh
榰	vieo
𦭜	vilh
𬃊	vieo
中	vsdg
种	vsxg
重	vsld
众	vsjj
钟	vszg
终	vsiw
忠	vsdh
肿	vsvg
冢	vswi
仲	vsjg
盅	vsda
锺	vszd
柊	vsew
踵	vspd
衷	vstg
舯	vsig
螽	vshc
茽	vslg
周	vbmd
轴	vbyd
州	vboo
粥	vbbb
咒	vbdo
肘	vbvk
洲	vbko
舟	vbio
皱	vbxr
昼	vbcf
纣	vbik
胄	vbdv
骤	vbnk
宙	vbwd
籀	vbrq
酎	vbyk
诌	vbsb
绉	vbib
帚	vbbr
辀	vbyi
啁	vbdd
鸼	vbix
赒	vbod
碡	vbmk
婤	vbbd
妯	vbbd
荮	vblk
㑇	vbjb
㤘	vbhb
主	vuin
住	vujn
注	vukn
煮	vuqc
猪	vumo
祝	vufp
著	vulo
朱	vuta
柱	vuen
诸	vuso
助	vufs
驻	vunn
竹	vuru
诛	vusa
渚	vuko
珠	vuna
株	vuea
铸	vuzk
逐	vuju
筑	vuri
蛛	vuca
箸	vuro
邾	vutt
铢	vuza
烛	vucc
蛀	vucn
贮	vuof
嘱	vudv
拄	vuun
炷	vucn
洙	vuka
茱	vula
伫	vujf
竺	vurm
纻	vuif
瞩	vuqv
苎	vulf
麈	vuxn
槠	vueo
舳	vuid
疰	vuan
杼	vuei
潴	vuko
侏	vuja
翥	vuqz
砫	vumn
柷	vuep
躅	vupc
蠋	vucc
橥	vume
术	vuei
瘃	vuai
𬣞	vusf
抓	vwuy
爪	vwya
髽	vwpg
拽	vyut
转	vryi
赚	vroc
专	vrmi
砖	vrmi
撰	vruh
传	vrji
篆	vrrj
馔	vrqh
颛	vrvw
僎	vrjh
啭	vrdi
瑑	vrnj
沌	vrks
䏝	vrvi
装	vdat
状	vdam
撞	vdud
庄	vdxg
妆	vdab
桩	vdeg
壮	vdag
幢	vdrd
戆	vdxh
奘	vdam
追	vvtu
坠	vvtg
锥	vvzu
缀	vvir
椎	vveu
隹	vvui
骓	vvnu
赘	vvao
缒	vviu
惴	vvhl
准	vpwu
肫	vpvs
屯	vpfs
谆	vpsh
窀	vpes
衠	vpph
𬘯	vpih
桌	voye
捉	voup
啄	vodi
卓	voyn
浊	vokc
灼	voci
着	vogq
拙	voum
斫	vomt
酌	voyi
叕	vorr
擢	vouu
濯	voku
焯	vocn
镯	vozc
琢	voni
涿	voki
汋	voki
倬	vojn
茁	volm
浞	vokp
椓	voei
禚	vofc
诼	vosi
棁	voep
晫	voon
䓬	voln
䦃	vozo
𬸦	volx
字	ziwh
自	zioi
子	zihi
紫	zisi
兹	zihi
资	ziwo
仔	zijh
籽	ziph
姿	ziwb
滋	ziki
渍	ziko
梓	zien
嗞	zidi
姊	zibt
咨	ziwd
恣	ziwh
赀	ziso
訾	ziss
髭	zipv
笫	zirt
粢	ziwp
吱	zidc
缁	ziiq
孖	zihh
眦	ziqv
孳	zihh
觜	zist
龇	zilv
孜	zihh
滓	zikn
辎	ziyq
淄	zikq
秭	zixt
茈	zilv
镃	zizi
耔	ziah
嵫	zivi
鼒	zina
虸	zich
锱	zizq
趑	zipe
鲻	ziwq
鄑	zift
总	zshh
宗	zswf
纵	zsij
棕	zsef
综	zsif
粽	zspf
踪	zspf
鬃	zspf
腙	zsvf
疭	zsaj
倧	zsjf
枞	zsej
鬷	zsnh
偬	zsjh
走	zbpz
揍	zbum
奏	zbam
邹	zbxt
陬	zbtr
诹	zbsr
驺	zbnb
鲰	zbwr
鄹	zbqt
组	zuif
族	zulo
足	zupu
租	zuxf
卒	zuzn
祖	zuff
阻	zutf
俎	zujf
菹	zulf
镞	zuzo
诅	zusf
崒	zuvn
珇	zunf
钻	zrzd
攥	zrui
纂	zrri
缵	zrio
躜	zrpo
最	zvor
嘴	zvdt
罪	zvyr
醉	zvyn
蕞	zvlr
槜	zvev
咀	zvdf
尊	zphk
遵	zphu
樽	zpek
鳟	zpwk
噂	zpdk
撙	zpuk
僔	zpjk
嶟	zpvk
𨱔	zpzk
做	zojh
作	zojw
坐	zojg
左	zonu
座	zoxg
佐	zoju
嘬	zodr
昨	zoow
撮	zour
唑	zodg
酢	zoyw
祚	zofw
琢	zoni
怍	zohw
阼	zotw
胙	zovw
捽	zoun
柞	zoew
笮	zorw
岞	zovw
